*********** # 1 **************
PokerStars Hand #214022070228: Tournament #2896837020, $0.98+$0.12 USD Hold'em No Limit - Level I (15/30) - 2020/05/17 9:15:13 ET
Table '2896837020 67' 9-max Seat #1 is the button
Seat 1: huytuan5443 (3000 in chips)
Seat 2: pokermich100 (3000 in chips)
Seat 3: Alexey747 (3000 in chips)
Seat 4: LakyG21 (3000 in chips)
Seat 5: VITALYA$333 (3000 in chips)
Seat 6: GuesWho'sBac (3000 in chips)
Seat 7: 19Tobi285 (3000 in chips)
Seat 8: elketefuka (3000 in chips)
Seat 9: TENSAI POKER (3000 in chips)
huytuan5443: posts the ante 4
pokermich100: posts the ante 4
Alexey747: posts the ante 4
LakyG21: posts the ante 4
VITALYA$333: posts the ante 4
GuesWho'sBac: posts the ante 4
19Tobi285: posts the ante 4
elketefuka: posts the ante 4
TENSAI POKER: posts the ante 4
pokermich100: posts small blind 15
Alexey747: posts big blind 30
*** HOLE CARDS ***
Dealt to elketefuka [3d 8h]
LakyG21: folds
VITALYA$333: folds
GuesWho'sBac: raises 60 to 90
19Tobi285: folds
elketefuka: folds
TENSAI POKER: folds
huytuan5443: folds
pokermich100: folds
Alexey747: calls 60
*** FLOP *** [Tc Ah Ad]
Alexey747: checks
GuesWho'sBac: checks
*** TURN *** [Tc Ah Ad] [8d]
Alexey747: bets 120
GuesWho'sBac: raises 210 to 330
Alexey747: calls 210
*** RIVER *** [Tc Ah Ad 8d] [Qc]
Alexey747: checks
GuesWho'sBac: bets 570
Alexey747: folds
Uncalled bet (570) returned to GuesWho'sBac
GuesWho'sBac collected 891 from pot
*** SUMMARY ***
Total pot 891 | Rake 0
Board [Tc Ah Ad 8d Qc]
Seat 1: huytuan5443 (button) folded before Flop (didn't bet)
Seat 2: pokermich100 (small blind) folded before Flop
Seat 3: Alexey747 (big blind) folded on the River
Seat 4: LakyG21 folded before Flop (didn't bet)
Seat 5: VITALYA$333 folded before Flop (didn't bet)
Seat 6: GuesWho'sBac collected (891)
Seat 7: 19Tobi285 folded before Flop (didn't bet)
Seat 8: elketefuka folded before Flop (didn't bet)
Seat 9: TENSAI POKER folded before Flop (didn't bet)


*********** # 2 **************
PokerStars Hand #214022133469: Tournament #2896837020, $0.98+$0.12 USD Hold'em No Limit - Level I (15/30) - 2020/05/17 9:16:44 ET
Table '2896837020 67' 9-max Seat #2 is the button
Seat 1: huytuan5443 (2996 in chips)
Seat 2: pokermich100 (2981 in chips)
Seat 3: Alexey747 (2576 in chips)
Seat 5: VITALYA$333 (2996 in chips)
Seat 6: GuesWho'sBac (3467 in chips)
Seat 7: 19Tobi285 (2996 in chips)
Seat 8: elketefuka (2996 in chips)
Seat 9: TENSAI POKER (2996 in chips)
huytuan5443: posts the ante 4
pokermich100: posts the ante 4
Alexey747: posts the ante 4
VITALYA$333: posts the ante 4
GuesWho'sBac: posts the ante 4
19Tobi285: posts the ante 4
elketefuka: posts the ante 4
TENSAI POKER: posts the ante 4
Alexey747: posts small blind 15
VITALYA$333: posts big blind 30
*** HOLE CARDS ***
Dealt to elketefuka [3d 2d]
GuesWho'sBac: folds
19Tobi285: folds
elketefuka: raises 30 to 60
TENSAI POKER: folds
huytuan5443: folds
pokermich100: folds
Alexey747: folds
VITALYA$333: calls 30
*** FLOP *** [9h Qs Qc]
VITALYA$333: checks
elketefuka: bets 90
VITALYA$333: calls 90
*** TURN *** [9h Qs Qc] [5c]
VITALYA$333: checks
elketefuka: checks
*** RIVER *** [9h Qs Qc 5c] [Jd]
VITALYA$333: checks
elketefuka: bets 230
VITALYA$333: folds
Uncalled bet (230) returned to elketefuka
elketefuka collected 347 from pot
elketefuka: doesn't show hand
*** SUMMARY ***
Total pot 347 | Rake 0
Board [9h Qs Qc 5c Jd]
Seat 1: huytuan5443 folded before Flop (didn't bet)
Seat 2: pokermich100 (button) folded before Flop (didn't bet)
Seat 3: Alexey747 (small blind) folded before Flop
Seat 5: VITALYA$333 (big blind) folded on the River
Seat 6: GuesWho'sBac folded before Flop (didn't bet)
Seat 7: 19Tobi285 folded before Flop (didn't bet)
Seat 8: elketefuka collected (347)
Seat 9: TENSAI POKER folded before Flop (didn't bet)


*********** # 3 **************
PokerStars Hand #214022188392: Tournament #2896837020, $0.98+$0.12 USD Hold'em No Limit - Level I (15/30) - 2020/05/17 9:18:02 ET
Table '2896837020 67' 9-max Seat #3 is the button
Seat 1: huytuan5443 (2992 in chips)
Seat 2: pokermich100 (2977 in chips)
Seat 3: Alexey747 (2557 in chips)
Seat 4: gleb2310 (3000 in chips) out of hand (moved from another table into small blind)
Seat 5: VITALYA$333 (2842 in chips)
Seat 6: GuesWho'sBac (3463 in chips)
Seat 7: 19Tobi285 (2992 in chips)
Seat 8: elketefuka (3189 in chips)
Seat 9: TENSAI POKER (2992 in chips)
gleb2310 will be allowed to play after the button
huytuan5443: posts the ante 4
pokermich100: posts the ante 4
Alexey747: posts the ante 4
VITALYA$333: posts the ante 4
GuesWho'sBac: posts the ante 4
19Tobi285: posts the ante 4
elketefuka: posts the ante 4
TENSAI POKER: posts the ante 4
VITALYA$333: posts small blind 15
GuesWho'sBac: posts big blind 30
*** HOLE CARDS ***
Dealt to elketefuka [Ks As]
19Tobi285: raises 34 to 64
elketefuka: raises 94 to 158
TENSAI POKER: folds
huytuan5443: folds
pokermich100: folds
Alexey747: folds
VITALYA$333: folds
GuesWho'sBac: folds
19Tobi285: calls 94
*** FLOP *** [Ac 9h Ah]
19Tobi285: checks
elketefuka: checks
*** TURN *** [Ac 9h Ah] [8d]
19Tobi285: bets 138
elketefuka: calls 138
*** RIVER *** [Ac 9h Ah 8d] [6c]
19Tobi285: bets 435
elketefuka: raises 454 to 889
19Tobi285: raises 1803 to 2692 and is all-in
elketefuka: calls 1803
*** SHOW DOWN ***
19Tobi285: shows [7d Ad] (three of a kind, Aces)
elketefuka: shows [Ks As] (three of a kind, Aces - King kicker)
elketefuka collected 6053 from pot
19Tobi285 finished the tournament in 3993rd place
*** SUMMARY ***
Total pot 6053 | Rake 0
Board [Ac 9h Ah 8d 6c]
Seat 1: huytuan5443 folded before Flop (didn't bet)
Seat 2: pokermich100 folded before Flop (didn't bet)
Seat 3: Alexey747 (button) folded before Flop (didn't bet)
Seat 5: VITALYA$333 (small blind) folded before Flop
Seat 6: GuesWho'sBac (big blind) folded before Flop
Seat 7: 19Tobi285 showed [7d Ad] and lost with three of a kind, Aces
Seat 8: elketefuka showed [Ks As] and won (6053) with three of a kind, Aces
Seat 9: TENSAI POKER folded before Flop (didn't bet)


*********** # 4 **************
PokerStars Hand #214022241027: Tournament #2896837020, $0.98+$0.12 USD Hold'em No Limit - Level I (15/30) - 2020/05/17 9:19:17 ET
Table '2896837020 67' 9-max Seat #5 is the button
Seat 1: huytuan5443 (2988 in chips)
Seat 2: pokermich100 (2973 in chips)
Seat 3: Alexey747 (2553 in chips)
Seat 4: gleb2310 (3000 in chips)
Seat 5: VITALYA$333 (2823 in chips)
Seat 6: GuesWho'sBac (3429 in chips)
Seat 7: marzocca696969 (3000 in chips)
Seat 8: elketefuka (6250 in chips)
Seat 9: TENSAI POKER (2988 in chips)
huytuan5443: posts the ante 4
pokermich100: posts the ante 4
Alexey747: posts the ante 4
gleb2310: posts the ante 4
VITALYA$333: posts the ante 4
GuesWho'sBac: posts the ante 4
marzocca696969: posts the ante 4
elketefuka: posts the ante 4
TENSAI POKER: posts the ante 4
GuesWho'sBac: posts small blind 15
marzocca696969: posts big blind 30
*** HOLE CARDS ***
Dealt to elketefuka [Jh 7h]
elketefuka: calls 30
TENSAI POKER: folds
huytuan5443: folds
pokermich100: calls 30
Alexey747: raises 30 to 60
gleb2310: raises 30 to 90
VITALYA$333: calls 90
GuesWho'sBac: folds
marzocca696969: calls 60
elketefuka: calls 60
pokermich100: calls 60
Alexey747: raises 2459 to 2549 and is all-in
gleb2310: raises 447 to 2996 and is all-in
VITALYA$333: folds
marzocca696969: folds
elketefuka: folds
pokermich100: folds
Uncalled bet (447) returned to gleb2310
*** FLOP *** [4d Ts Kh]
*** TURN *** [4d Ts Kh] [Ah]
*** RIVER *** [4d Ts Kh Ah] [9c]
*** SHOW DOWN ***
Alexey747: shows [Qs Qd] (a pair of Queens)
gleb2310: shows [Td Tc] (three of a kind, Tens)
gleb2310 collected 5509 from pot
Alexey747 finished the tournament in 3984th place
*** SUMMARY ***
Total pot 5509 | Rake 0
Board [4d Ts Kh Ah 9c]
Seat 1: huytuan5443 folded before Flop (didn't bet)
Seat 2: pokermich100 folded before Flop
Seat 3: Alexey747 showed [Qs Qd] and lost with a pair of Queens
Seat 4: gleb2310 showed [Td Tc] and won (5509) with three of a kind, Tens
Seat 5: VITALYA$333 (button) folded before Flop
Seat 6: GuesWho'sBac (small blind) folded before Flop
Seat 7: marzocca696969 (big blind) folded before Flop
Seat 8: elketefuka folded before Flop
Seat 9: TENSAI POKER folded before Flop (didn't bet)


*********** # 5 **************
PokerStars Hand #214022286934: Tournament #2896837020, $0.98+$0.12 USD Hold'em No Limit - Level I (15/30) - 2020/05/17 9:20:22 ET
Table '2896837020 67' 9-max Seat #6 is the button
Seat 1: huytuan5443 (2984 in chips)
Seat 2: pokermich100 (2879 in chips)
Seat 4: gleb2310 (5956 in chips)
Seat 5: VITALYA$333 (2729 in chips)
Seat 6: GuesWho'sBac (3410 in chips)
Seat 7: marzocca696969 (2906 in chips)
Seat 8: elketefuka (6156 in chips)
Seat 9: TENSAI POKER (2984 in chips)
huytuan5443: posts the ante 4
pokermich100: posts the ante 4
gleb2310: posts the ante 4
VITALYA$333: posts the ante 4
GuesWho'sBac: posts the ante 4
marzocca696969: posts the ante 4
elketefuka: posts the ante 4
TENSAI POKER: posts the ante 4
marzocca696969: posts small blind 15
elketefuka: posts big blind 30
*** HOLE CARDS ***
Dealt to elketefuka [Ts Jc]
TENSAI POKER: folds
huytuan5443: folds
pokermich100: folds
gleb2310: calls 30
VITALYA$333: folds
GuesWho'sBac: folds
marzocca696969: calls 15
elketefuka: checks
*** FLOP *** [Ac Qd 7c]
marzocca696969: checks
elketefuka: checks
gleb2310: checks
*** TURN *** [Ac Qd 7c] [6h]
marzocca696969: checks
elketefuka: bets 61
gleb2310: calls 61
marzocca696969: folds
*** RIVER *** [Ac Qd 7c 6h] [9d]
elketefuka: bets 130
gleb2310: folds
Uncalled bet (130) returned to elketefuka
elketefuka collected 244 from pot
elketefuka: doesn't show hand
*** SUMMARY ***
Total pot 244 | Rake 0
Board [Ac Qd 7c 6h 9d]
Seat 1: huytuan5443 folded before Flop (didn't bet)
Seat 2: pokermich100 folded before Flop (didn't bet)
Seat 4: gleb2310 folded on the River
Seat 5: VITALYA$333 folded before Flop (didn't bet)
Seat 6: GuesWho'sBac (button) folded before Flop (didn't bet)
Seat 7: marzocca696969 (small blind) folded on the Turn
Seat 8: elketefuka (big blind) collected (244)
Seat 9: TENSAI POKER folded before Flop (didn't bet)


*********** # 6 **************
PokerStars Hand #214022334652: Tournament #2896837020, $0.98+$0.12 USD Hold'em No Limit - Level I (15/30) - 2020/05/17 9:21:30 ET
Table '2896837020 67' 9-max Seat #7 is the button
Seat 1: huytuan5443 (2980 in chips)
Seat 2: pokermich100 (2875 in chips)
Seat 3: rmooring1 (3000 in chips)
Seat 4: gleb2310 (5861 in chips)
Seat 5: VITALYA$333 (2725 in chips)
Seat 6: GuesWho'sBac (3406 in chips)
Seat 7: marzocca696969 (2872 in chips)
Seat 8: elketefuka (6305 in chips)
Seat 9: TENSAI POKER (2980 in chips)
huytuan5443: posts the ante 4
pokermich100: posts the ante 4
rmooring1: posts the ante 4
gleb2310: posts the ante 4
VITALYA$333: posts the ante 4
GuesWho'sBac: posts the ante 4
marzocca696969: posts the ante 4
elketefuka: posts the ante 4
TENSAI POKER: posts the ante 4
elketefuka: posts small blind 15
TENSAI POKER: posts big blind 30
*** HOLE CARDS ***
Dealt to elketefuka [Kh 5s]
huytuan5443: raises 30 to 60
pokermich100: folds
rmooring1: raises 30 to 90
gleb2310: folds
VITALYA$333: folds
GuesWho'sBac: folds
marzocca696969: folds
elketefuka: folds
TENSAI POKER: calls 60
huytuan5443: raises 240 to 330
rmooring1: calls 240
TENSAI POKER: folds
*** FLOP *** [3s 8c 9h]
huytuan5443: checks
rmooring1: bets 90
huytuan5443: calls 90
*** TURN *** [3s 8c 9h] [8h]
huytuan5443: checks
rmooring1: bets 30
huytuan5443: calls 30
*** RIVER *** [3s 8c 9h 8h] [3c]
huytuan5443: bets 333
rmooring1: calls 333
*** SHOW DOWN ***
huytuan5443: shows [Js Ad] (two pair, Eights and Threes)
rmooring1: shows [Qd 9c] (two pair, Nines and Eights)
rmooring1 collected 1707 from pot
*** SUMMARY ***
Total pot 1707 | Rake 0
Board [3s 8c 9h 8h 3c]
Seat 1: huytuan5443 showed [Js Ad] and lost with two pair, Eights and Threes
Seat 2: pokermich100 folded before Flop (didn't bet)
Seat 3: rmooring1 showed [Qd 9c] and won (1707) with two pair, Nines and Eights
Seat 4: gleb2310 folded before Flop (didn't bet)
Seat 5: VITALYA$333 folded before Flop (didn't bet)
Seat 6: GuesWho'sBac folded before Flop (didn't bet)
Seat 7: marzocca696969 (button) folded before Flop (didn't bet)
Seat 8: elketefuka (small blind) folded before Flop
Seat 9: TENSAI POKER (big blind) folded before Flop


*********** # 7 **************
PokerStars Hand #214022404290: Tournament #2896837020, $0.98+$0.12 USD Hold'em No Limit - Level I (15/30) - 2020/05/17 9:23:08 ET
Table '2896837020 67' 9-max Seat #8 is the button
Seat 1: huytuan5443 (2193 in chips)
Seat 2: pokermich100 (2871 in chips)
Seat 3: rmooring1 (3920 in chips)
Seat 4: gleb2310 (5857 in chips)
Seat 5: VITALYA$333 (2721 in chips)
Seat 6: GuesWho'sBac (3402 in chips)
Seat 7: marzocca696969 (2868 in chips)
Seat 8: elketefuka (6286 in chips)
Seat 9: TENSAI POKER (2886 in chips)
huytuan5443: posts the ante 4
pokermich100: posts the ante 4
rmooring1: posts the ante 4
gleb2310: posts the ante 4
VITALYA$333: posts the ante 4
GuesWho'sBac: posts the ante 4
marzocca696969: posts the ante 4
elketefuka: posts the ante 4
TENSAI POKER: posts the ante 4
TENSAI POKER: posts small blind 15
huytuan5443: posts big blind 30
*** HOLE CARDS ***
Dealt to elketefuka [Jd Qs]
pokermich100: raises 60 to 90
rmooring1: folds
gleb2310: calls 90
VITALYA$333: folds
GuesWho'sBac: folds
marzocca696969: calls 90
elketefuka: calls 90
TENSAI POKER: raises 330 to 420
huytuan5443: folds
pokermich100: folds
gleb2310: folds
marzocca696969: calls 330
elketefuka: folds
*** FLOP *** [Kd 9c 3d]
TENSAI POKER: bets 423
marzocca696969: folds
Uncalled bet (423) returned to TENSAI POKER
TENSAI POKER collected 1176 from pot
TENSAI POKER: doesn't show hand
*** SUMMARY ***
Total pot 1176 | Rake 0
Board [Kd 9c 3d]
Seat 1: huytuan5443 (big blind) folded before Flop
Seat 2: pokermich100 folded before Flop
Seat 3: rmooring1 folded before Flop (didn't bet)
Seat 4: gleb2310 folded before Flop
Seat 5: VITALYA$333 folded before Flop (didn't bet)
Seat 6: GuesWho'sBac folded before Flop (didn't bet)
Seat 7: marzocca696969 folded on the Flop
Seat 8: elketefuka (button) folded before Flop
Seat 9: TENSAI POKER (small blind) collected (1176)


*********** # 8 **************
PokerStars Hand #214022466663: Tournament #2896837020, $0.98+$0.12 USD Hold'em No Limit - Level I (15/30) - 2020/05/17 9:24:37 ET
Table '2896837020 67' 9-max Seat #9 is the button
Seat 1: huytuan5443 (2159 in chips)
Seat 2: pokermich100 (2777 in chips)
Seat 3: rmooring1 (3916 in chips)
Seat 4: gleb2310 (5763 in chips)
Seat 5: VITALYA$333 (2717 in chips)
Seat 6: GuesWho'sBac (3398 in chips)
Seat 7: marzocca696969 (2444 in chips)
Seat 8: elketefuka (6192 in chips)
Seat 9: TENSAI POKER (3638 in chips)
huytuan5443: posts the ante 4
pokermich100: posts the ante 4
rmooring1: posts the ante 4
gleb2310: posts the ante 4
VITALYA$333: posts the ante 4
GuesWho'sBac: posts the ante 4
marzocca696969: posts the ante 4
elketefuka: posts the ante 4
TENSAI POKER: posts the ante 4
huytuan5443: posts small blind 15
pokermich100: posts big blind 30
*** HOLE CARDS ***
Dealt to elketefuka [Kd 4h]
rmooring1: raises 30 to 60
gleb2310: calls 60
VITALYA$333: folds
GuesWho'sBac: calls 60
marzocca696969: folds
elketefuka: folds
TENSAI POKER: folds
huytuan5443: folds
pokermich100: calls 30
*** FLOP *** [Tc 5c Ac]
pokermich100: checks
rmooring1: bets 146
gleb2310: calls 146
GuesWho'sBac: folds
pokermich100: folds
*** TURN *** [Tc 5c Ac] [5d]
rmooring1: bets 30
gleb2310: calls 30
*** RIVER *** [Tc 5c Ac 5d] [7s]
rmooring1: checks
gleb2310: bets 300
rmooring1: folds
Uncalled bet (300) returned to gleb2310
gleb2310 collected 643 from pot
gleb2310: doesn't show hand
*** SUMMARY ***
Total pot 643 | Rake 0
Board [Tc 5c Ac 5d 7s]
Seat 1: huytuan5443 (small blind) folded before Flop
Seat 2: pokermich100 (big blind) folded on the Flop
Seat 3: rmooring1 folded on the River
Seat 4: gleb2310 collected (643)
Seat 5: VITALYA$333 folded before Flop (didn't bet)
Seat 6: GuesWho'sBac folded on the Flop
Seat 7: marzocca696969 folded before Flop (didn't bet)
Seat 8: elketefuka folded before Flop (didn't bet)
Seat 9: TENSAI POKER (button) folded before Flop (didn't bet)


*********** # 9 **************
PokerStars Hand #214022529716: Tournament #2896837020, $0.98+$0.12 USD Hold'em No Limit - Level II (20/40) - 2020/05/17 9:26:06 ET
Table '2896837020 67' 9-max Seat #1 is the button
Seat 1: huytuan5443 (2140 in chips)
Seat 2: pokermich100 (2713 in chips)
Seat 3: rmooring1 (3676 in chips)
Seat 4: gleb2310 (6166 in chips)
Seat 5: VITALYA$333 (2713 in chips)
Seat 6: GuesWho'sBac (3334 in chips)
Seat 7: marzocca696969 (2440 in chips)
Seat 8: elketefuka (6188 in chips)
Seat 9: TENSAI POKER (3634 in chips)
huytuan5443: posts the ante 5
pokermich100: posts the ante 5
rmooring1: posts the ante 5
gleb2310: posts the ante 5
VITALYA$333: posts the ante 5
GuesWho'sBac: posts the ante 5
marzocca696969: posts the ante 5
elketefuka: posts the ante 5
TENSAI POKER: posts the ante 5
pokermich100: posts small blind 20
rmooring1: posts big blind 40
*** HOLE CARDS ***
Dealt to elketefuka [Kh Qd]
gleb2310: raises 80 to 120
VITALYA$333: folds
GuesWho'sBac: folds
marzocca696969: calls 120
elketefuka: calls 120
TENSAI POKER: folds
huytuan5443: folds
pokermich100: folds
rmooring1: calls 80
*** FLOP *** [6s 4c 9s]
rmooring1: checks
gleb2310: checks
marzocca696969: bets 560
elketefuka: folds
rmooring1: folds
gleb2310: folds
Uncalled bet (560) returned to marzocca696969
marzocca696969 collected 545 from pot
marzocca696969: doesn't show hand
*** SUMMARY ***
Total pot 545 | Rake 0
Board [6s 4c 9s]
Seat 1: huytuan5443 (button) folded before Flop (didn't bet)
Seat 2: pokermich100 (small blind) folded before Flop
Seat 3: rmooring1 (big blind) folded on the Flop
Seat 4: gleb2310 folded on the Flop
Seat 5: VITALYA$333 folded before Flop (didn't bet)
Seat 6: GuesWho'sBac folded before Flop (didn't bet)
Seat 7: marzocca696969 collected (545)
Seat 8: elketefuka folded on the Flop
Seat 9: TENSAI POKER folded before Flop (didn't bet)


*********** # 10 **************
PokerStars Hand #214022572389: Tournament #2896837020, $0.98+$0.12 USD Hold'em No Limit - Level II (20/40) - 2020/05/17 9:27:06 ET
Table '2896837020 67' 9-max Seat #2 is the button
Seat 1: huytuan5443 (2135 in chips)
Seat 2: pokermich100 (2688 in chips)
Seat 3: rmooring1 (3551 in chips)
Seat 4: gleb2310 (6041 in chips)
Seat 5: VITALYA$333 (2708 in chips)
Seat 6: GuesWho'sBac (3329 in chips)
Seat 7: marzocca696969 (2860 in chips)
Seat 8: elketefuka (6063 in chips)
Seat 9: TENSAI POKER (3629 in chips)
huytuan5443: posts the ante 5
pokermich100: posts the ante 5
rmooring1: posts the ante 5
gleb2310: posts the ante 5
VITALYA$333: posts the ante 5
GuesWho'sBac: posts the ante 5
marzocca696969: posts the ante 5
elketefuka: posts the ante 5
TENSAI POKER: posts the ante 5
rmooring1: posts small blind 20
gleb2310: posts big blind 40
*** HOLE CARDS ***
Dealt to elketefuka [Qh Qc]
VITALYA$333: folds
GuesWho'sBac: raises 80 to 120
marzocca696969: folds
elketefuka: raises 280 to 400
TENSAI POKER: folds
huytuan5443: raises 1730 to 2130 and is all-in
pokermich100: folds
rmooring1: folds
gleb2310: folds
GuesWho'sBac: raises 1194 to 3324 and is all-in
elketefuka: calls 2924
*** FLOP *** [Jc 9d 9h]
*** TURN *** [Jc 9d 9h] [Th]
*** RIVER *** [Jc 9d 9h Th] [8d]
*** SHOW DOWN ***
GuesWho'sBac: shows [Ad As] (two pair, Aces and Nines)
elketefuka: shows [Qh Qc] (a straight, Eight to Queen)
elketefuka collected 2388 from side pot
huytuan5443: shows [6h 6c] (two pair, Nines and Sixes)
elketefuka collected 6495 from main pot
GuesWho'sBac finished the tournament in 3902nd place
huytuan5443 finished the tournament in 3903rd place
*** SUMMARY ***
Total pot 8883 Main pot 6495. Side pot 2388. | Rake 0
Board [Jc 9d 9h Th 8d]
Seat 1: huytuan5443 showed [6h 6c] and lost with two pair, Nines and Sixes
Seat 2: pokermich100 (button) folded before Flop (didn't bet)
Seat 3: rmooring1 (small blind) folded before Flop
Seat 4: gleb2310 (big blind) folded before Flop
Seat 5: VITALYA$333 folded before Flop (didn't bet)
Seat 6: GuesWho'sBac showed [Ad As] and lost with two pair, Aces and Nines
Seat 7: marzocca696969 folded before Flop (didn't bet)
Seat 8: elketefuka showed [Qh Qc] and won (8883) with a straight, Eight to Queen
Seat 9: TENSAI POKER folded before Flop (didn't bet)


*********** # 11 **************
PokerStars Hand #214022630303: Tournament #2896837020, $0.98+$0.12 USD Hold'em No Limit - Level II (20/40) - 2020/05/17 9:28:27 ET
Table '2896837020 67' 9-max Seat #3 is the button
Seat 2: pokermich100 (2683 in chips)
Seat 3: rmooring1 (3526 in chips)
Seat 4: gleb2310 (5996 in chips)
Seat 5: VITALYA$333 (2703 in chips)
Seat 6: SuperQ22 (2886 in chips)
Seat 7: marzocca696969 (2855 in chips)
Seat 8: elketefuka (11617 in chips)
Seat 9: TENSAI POKER (3624 in chips)
pokermich100: posts the ante 5
rmooring1: posts the ante 5
gleb2310: posts the ante 5
VITALYA$333: posts the ante 5
SuperQ22: posts the ante 5
marzocca696969: posts the ante 5
elketefuka: posts the ante 5
TENSAI POKER: posts the ante 5
gleb2310: posts small blind 20
VITALYA$333: posts big blind 40
*** HOLE CARDS ***
Dealt to elketefuka [Ah 8c]
SuperQ22: folds
marzocca696969: folds
elketefuka: calls 40
TENSAI POKER: raises 112 to 152
pokermich100: folds
rmooring1: calls 152
gleb2310: folds
VITALYA$333: folds
elketefuka: calls 112
*** FLOP *** [6h 4s Js]
elketefuka: checks
TENSAI POKER: checks
rmooring1: checks
*** TURN *** [6h 4s Js] [Jc]
elketefuka: bets 240
TENSAI POKER: folds
rmooring1: folds
Uncalled bet (240) returned to elketefuka
elketefuka collected 556 from pot
elketefuka: doesn't show hand
*** SUMMARY ***
Total pot 556 | Rake 0
Board [6h 4s Js Jc]
Seat 2: pokermich100 folded before Flop (didn't bet)
Seat 3: rmooring1 (button) folded on the Turn
Seat 4: gleb2310 (small blind) folded before Flop
Seat 5: VITALYA$333 (big blind) folded before Flop
Seat 6: SuperQ22 folded before Flop (didn't bet)
Seat 7: marzocca696969 folded before Flop (didn't bet)
Seat 8: elketefuka collected (556)
Seat 9: TENSAI POKER folded on the Turn


*********** # 12 **************
PokerStars Hand #214022697622: Tournament #2896837020, $0.98+$0.12 USD Hold'em No Limit - Level II (20/40) - 2020/05/17 9:30:00 ET
Table '2896837020 67' 9-max Seat #4 is the button
Seat 1: psitorch (3000 in chips)
Seat 2: pokermich100 (2678 in chips)
Seat 3: rmooring1 (3369 in chips)
Seat 4: gleb2310 (5971 in chips)
Seat 5: VITALYA$333 (2658 in chips)
Seat 6: SuperQ22 (2881 in chips)
Seat 7: marzocca696969 (2850 in chips)
Seat 8: elketefuka (12016 in chips)
Seat 9: TENSAI POKER (3467 in chips)
psitorch: posts the ante 5
pokermich100: posts the ante 5
rmooring1: posts the ante 5
gleb2310: posts the ante 5
VITALYA$333: posts the ante 5
SuperQ22: posts the ante 5
marzocca696969: posts the ante 5
elketefuka: posts the ante 5
TENSAI POKER: posts the ante 5
VITALYA$333: posts small blind 20
SuperQ22: posts big blind 40
*** HOLE CARDS ***
Dealt to elketefuka [3s Ah]
marzocca696969: folds
elketefuka: calls 40
TENSAI POKER: folds
psitorch: folds
pokermich100: raises 140 to 180
rmooring1: calls 180
gleb2310: folds
VITALYA$333: folds
SuperQ22: folds
elketefuka: folds
*** FLOP *** [3h Qd 9s]
pokermich100: bets 253
rmooring1: folds
Uncalled bet (253) returned to pokermich100
pokermich100 collected 505 from pot
pokermich100: doesn't show hand
*** SUMMARY ***
Total pot 505 | Rake 0
Board [3h Qd 9s]
Seat 1: psitorch folded before Flop (didn't bet)
Seat 2: pokermich100 collected (505)
Seat 3: rmooring1 folded on the Flop
Seat 4: gleb2310 (button) folded before Flop (didn't bet)
Seat 5: VITALYA$333 (small blind) folded before Flop
Seat 6: SuperQ22 (big blind) folded before Flop
Seat 7: marzocca696969 folded before Flop (didn't bet)
Seat 8: elketefuka folded before Flop
Seat 9: TENSAI POKER folded before Flop (didn't bet)


*********** # 13 **************
PokerStars Hand #214022739843: Tournament #2896837020, $0.98+$0.12 USD Hold'em No Limit - Level II (20/40) - 2020/05/17 9:30:58 ET
Table '2896837020 67' 9-max Seat #5 is the button
Seat 1: psitorch (2995 in chips)
Seat 2: pokermich100 (2998 in chips)
Seat 3: rmooring1 (3184 in chips)
Seat 4: gleb2310 (5966 in chips)
Seat 5: VITALYA$333 (2633 in chips)
Seat 6: SuperQ22 (2836 in chips)
Seat 7: marzocca696969 (2845 in chips)
Seat 8: elketefuka (11971 in chips)
Seat 9: TENSAI POKER (3462 in chips)
psitorch: posts the ante 5
pokermich100: posts the ante 5
rmooring1: posts the ante 5
gleb2310: posts the ante 5
VITALYA$333: posts the ante 5
SuperQ22: posts the ante 5
marzocca696969: posts the ante 5
elketefuka: posts the ante 5
TENSAI POKER: posts the ante 5
SuperQ22: posts small blind 20
marzocca696969: posts big blind 40
*** HOLE CARDS ***
Dealt to elketefuka [Td 2h]
elketefuka: folds
TENSAI POKER: folds
psitorch: folds
pokermich100: raises 80 to 120
rmooring1: calls 120
gleb2310: calls 120
VITALYA$333: folds
SuperQ22: folds
marzocca696969: folds
*** FLOP *** [2d 7h 3s]
pokermich100: checks
rmooring1: bets 465
gleb2310: folds
pokermich100: folds
Uncalled bet (465) returned to rmooring1
rmooring1 collected 465 from pot
rmooring1: doesn't show hand
*** SUMMARY ***
Total pot 465 | Rake 0
Board [2d 7h 3s]
Seat 1: psitorch folded before Flop (didn't bet)
Seat 2: pokermich100 folded on the Flop
Seat 3: rmooring1 collected (465)
Seat 4: gleb2310 folded on the Flop
Seat 5: VITALYA$333 (button) folded before Flop (didn't bet)
Seat 6: SuperQ22 (small blind) folded before Flop
Seat 7: marzocca696969 (big blind) folded before Flop
Seat 8: elketefuka folded before Flop (didn't bet)
Seat 9: TENSAI POKER folded before Flop (didn't bet)


*********** # 14 **************
PokerStars Hand #214022794844: Tournament #2896837020, $0.98+$0.12 USD Hold'em No Limit - Level II (20/40) - 2020/05/17 9:32:15 ET
Table '2896837020 67' 9-max Seat #6 is the button
Seat 1: psitorch (2990 in chips)
Seat 2: pokermich100 (2873 in chips)
Seat 3: rmooring1 (3524 in chips)
Seat 4: gleb2310 (5841 in chips)
Seat 5: VITALYA$333 (2628 in chips)
Seat 6: SuperQ22 (2811 in chips)
Seat 7: marzocca696969 (2800 in chips)
Seat 8: elketefuka (11966 in chips)
Seat 9: TENSAI POKER (3457 in chips)
psitorch: posts the ante 5
pokermich100: posts the ante 5
rmooring1: posts the ante 5
gleb2310: posts the ante 5
VITALYA$333: posts the ante 5
SuperQ22: posts the ante 5
marzocca696969: posts the ante 5
elketefuka: posts the ante 5
TENSAI POKER: posts the ante 5
marzocca696969: posts small blind 20
elketefuka: posts big blind 40
*** HOLE CARDS ***
Dealt to elketefuka [9c Kh]
TENSAI POKER: raises 60 to 100
psitorch: folds
pokermich100: folds
rmooring1: folds
gleb2310: raises 60 to 160
VITALYA$333: folds
SuperQ22: folds
marzocca696969: folds
elketefuka: folds
TENSAI POKER: calls 60
*** FLOP *** [Jh Js 5h]
TENSAI POKER: checks
gleb2310: checks
*** TURN *** [Jh Js 5h] [7h]
TENSAI POKER: checks
gleb2310: bets 200
TENSAI POKER: calls 200
*** RIVER *** [Jh Js 5h 7h] [Ah]
TENSAI POKER: checks
gleb2310: checks
*** SHOW DOWN ***
TENSAI POKER: shows [Qs As] (two pair, Aces and Jacks)
gleb2310: shows [Jd 8d] (three of a kind, Jacks)
gleb2310 collected 825 from pot
*** SUMMARY ***
Total pot 825 | Rake 0
Board [Jh Js 5h 7h Ah]
Seat 1: psitorch folded before Flop (didn't bet)
Seat 2: pokermich100 folded before Flop (didn't bet)
Seat 3: rmooring1 folded before Flop (didn't bet)
Seat 4: gleb2310 showed [Jd 8d] and won (825) with three of a kind, Jacks
Seat 5: VITALYA$333 folded before Flop (didn't bet)
Seat 6: SuperQ22 (button) folded before Flop (didn't bet)
Seat 7: marzocca696969 (small blind) folded before Flop
Seat 8: elketefuka (big blind) folded before Flop
Seat 9: TENSAI POKER showed [Qs As] and lost with two pair, Aces and Jacks


*********** # 15 **************
PokerStars Hand #214022876977: Tournament #2896837020, $0.98+$0.12 USD Hold'em No Limit - Level II (20/40) - 2020/05/17 9:34:08 ET
Table '2896837020 67' 9-max Seat #7 is the button
Seat 1: psitorch (2985 in chips)
Seat 2: pokermich100 (2868 in chips)
Seat 3: rmooring1 (3519 in chips)
Seat 4: gleb2310 (6301 in chips)
Seat 5: VITALYA$333 (2623 in chips)
Seat 6: SuperQ22 (2806 in chips)
Seat 7: marzocca696969 (2775 in chips)
Seat 8: elketefuka (11921 in chips)
Seat 9: TENSAI POKER (3092 in chips)
psitorch: posts the ante 5
pokermich100: posts the ante 5
rmooring1: posts the ante 5
gleb2310: posts the ante 5
VITALYA$333: posts the ante 5
SuperQ22: posts the ante 5
marzocca696969: posts the ante 5
elketefuka: posts the ante 5
TENSAI POKER: posts the ante 5
elketefuka: posts small blind 20
TENSAI POKER: posts big blind 40
*** HOLE CARDS ***
Dealt to elketefuka [4c As]
psitorch: folds
pokermich100: folds
rmooring1: raises 120 to 160
gleb2310: folds
VITALYA$333: calls 160
SuperQ22: folds
marzocca696969: folds
elketefuka: folds
TENSAI POKER: folds
*** FLOP *** [7h Qh Jh]
rmooring1: bets 213
VITALYA$333: folds
Uncalled bet (213) returned to rmooring1
rmooring1 collected 425 from pot
rmooring1: doesn't show hand
*** SUMMARY ***
Total pot 425 | Rake 0
Board [7h Qh Jh]
Seat 1: psitorch folded before Flop (didn't bet)
Seat 2: pokermich100 folded before Flop (didn't bet)
Seat 3: rmooring1 collected (425)
Seat 4: gleb2310 folded before Flop (didn't bet)
Seat 5: VITALYA$333 folded on the Flop
Seat 6: SuperQ22 folded before Flop (didn't bet)
Seat 7: marzocca696969 (button) folded before Flop (didn't bet)
Seat 8: elketefuka (small blind) folded before Flop
Seat 9: TENSAI POKER (big blind) folded before Flop


*********** # 16 **************
PokerStars Hand #214022928583: Tournament #2896837020, $0.98+$0.12 USD Hold'em No Limit - Level III (25/50) - 2020/05/17 9:35:20 ET
Table '2896837020 67' 9-max Seat #8 is the button
Seat 1: psitorch (2980 in chips)
Seat 2: pokermich100 (2863 in chips)
Seat 3: rmooring1 (3779 in chips)
Seat 4: gleb2310 (6296 in chips)
Seat 5: VITALYA$333 (2458 in chips)
Seat 6: SuperQ22 (2801 in chips)
Seat 7: marzocca696969 (2770 in chips)
Seat 8: elketefuka (11896 in chips)
Seat 9: TENSAI POKER (3047 in chips)
psitorch: posts the ante 6
pokermich100: posts the ante 6
rmooring1: posts the ante 6
gleb2310: posts the ante 6
VITALYA$333: posts the ante 6
SuperQ22: posts the ante 6
marzocca696969: posts the ante 6
elketefuka: posts the ante 6
TENSAI POKER: posts the ante 6
TENSAI POKER: posts small blind 25
psitorch: posts big blind 50
*** HOLE CARDS ***
Dealt to elketefuka [Qs 7s]
pokermich100: raises 100 to 150
rmooring1: folds
gleb2310: calls 150
VITALYA$333: folds
SuperQ22: folds
marzocca696969: folds
elketefuka: calls 150
TENSAI POKER: calls 125
psitorch: calls 100
*** FLOP *** [2d Kd Qh]
TENSAI POKER: checks
psitorch: checks
pokermich100: bets 475
gleb2310: calls 475
elketefuka: calls 475
TENSAI POKER: folds
psitorch: folds
*** TURN *** [2d Kd Qh] [6s]
pokermich100: bets 2232 and is all-in
gleb2310: raises 3433 to 5665 and is all-in
elketefuka: folds
Uncalled bet (3433) returned to gleb2310
*** RIVER *** [2d Kd Qh 6s] [8c]
*** SHOW DOWN ***
pokermich100: shows [Kh Qc] (two pair, Kings and Queens)
gleb2310: shows [Jd Kc] (a pair of Kings)
pokermich100 collected 6693 from pot
*** SUMMARY ***
Total pot 6693 | Rake 0
Board [2d Kd Qh 6s 8c]
Seat 1: psitorch (big blind) folded on the Flop
Seat 2: pokermich100 showed [Kh Qc] and won (6693) with two pair, Kings and Queens
Seat 3: rmooring1 folded before Flop (didn't bet)
Seat 4: gleb2310 showed [Jd Kc] and lost with a pair of Kings
Seat 5: VITALYA$333 folded before Flop (didn't bet)
Seat 6: SuperQ22 folded before Flop (didn't bet)
Seat 7: marzocca696969 folded before Flop (didn't bet)
Seat 8: elketefuka (button) folded on the Turn
Seat 9: TENSAI POKER (small blind) folded on the Flop


*********** # 17 **************
PokerStars Hand #214023005902: Tournament #2896837020, $0.98+$0.12 USD Hold'em No Limit - Level III (25/50) - 2020/05/17 9:37:07 ET
Table '2896837020 67' 9-max Seat #9 is the button
Seat 1: psitorch (2824 in chips)
Seat 3: rmooring1 (3773 in chips)
Seat 4: gleb2310 (3433 in chips)
Seat 5: VITALYA$333 (2452 in chips)
Seat 6: SuperQ22 (2795 in chips)
Seat 7: marzocca696969 (2764 in chips)
Seat 8: elketefuka (11265 in chips)
Seat 9: TENSAI POKER (2891 in chips)
psitorch: posts the ante 6
rmooring1: posts the ante 6
gleb2310: posts the ante 6
VITALYA$333: posts the ante 6
SuperQ22: posts the ante 6
marzocca696969: posts the ante 6
elketefuka: posts the ante 6
TENSAI POKER: posts the ante 6
psitorch: posts small blind 25
rmooring1: posts big blind 50
*** HOLE CARDS ***
Dealt to elketefuka [Ks Js]
gleb2310: folds
VITALYA$333: folds
SuperQ22: folds
marzocca696969: folds
elketefuka: raises 100 to 150
TENSAI POKER: folds
psitorch: folds
rmooring1: folds
Uncalled bet (100) returned to elketefuka
elketefuka collected 173 from pot
elketefuka: doesn't show hand
*** SUMMARY ***
Total pot 173 | Rake 0
Seat 1: psitorch (small blind) folded before Flop
Seat 3: rmooring1 (big blind) folded before Flop
Seat 4: gleb2310 folded before Flop (didn't bet)
Seat 5: VITALYA$333 folded before Flop (didn't bet)
Seat 6: SuperQ22 folded before Flop (didn't bet)
Seat 7: marzocca696969 folded before Flop (didn't bet)
Seat 8: elketefuka collected (173)
Seat 9: TENSAI POKER (button) folded before Flop (didn't bet)


*********** # 18 **************
PokerStars Hand #214023030756: Tournament #2896837020, $0.98+$0.12 USD Hold'em No Limit - Level III (25/50) - 2020/05/17 9:37:41 ET
Table '2896837020 67' 9-max Seat #1 is the button
Seat 1: psitorch (2793 in chips)
Seat 2: Tolebi (3000 in chips) out of hand (moved from another table into small blind)
Seat 3: rmooring1 (3717 in chips)
Seat 4: gleb2310 (3427 in chips)
Seat 5: VITALYA$333 (2446 in chips)
Seat 6: SuperQ22 (2789 in chips)
Seat 7: marzocca696969 (2758 in chips)
Seat 8: elketefuka (11382 in chips)
Seat 9: TENSAI POKER (2885 in chips)
Tolebi will be allowed to play after the button
psitorch: posts the ante 6
rmooring1: posts the ante 6
gleb2310: posts the ante 6
VITALYA$333: posts the ante 6
SuperQ22: posts the ante 6
marzocca696969: posts the ante 6
elketefuka: posts the ante 6
TENSAI POKER: posts the ante 6
rmooring1: posts small blind 25
gleb2310: posts big blind 50
*** HOLE CARDS ***
Dealt to elketefuka [Qc Kd]
VITALYA$333: folds
SuperQ22: raises 60 to 110
marzocca696969: calls 110
elketefuka: calls 110
TENSAI POKER: folds
psitorch: folds
rmooring1: raises 3601 to 3711 and is all-in
gleb2310: folds
SuperQ22: folds
marzocca696969: folds
elketefuka: folds
Uncalled bet (3601) returned to rmooring1
rmooring1 collected 538 from pot
rmooring1: doesn't show hand
*** SUMMARY ***
Total pot 538 | Rake 0
Seat 1: psitorch (button) folded before Flop (didn't bet)
Seat 3: rmooring1 (small blind) collected (538)
Seat 4: gleb2310 (big blind) folded before Flop
Seat 5: VITALYA$333 folded before Flop (didn't bet)
Seat 6: SuperQ22 folded before Flop
Seat 7: marzocca696969 folded before Flop
Seat 8: elketefuka folded before Flop
Seat 9: TENSAI POKER folded before Flop (didn't bet)


*********** # 19 **************
PokerStars Hand #214023066033: Tournament #2896837020, $0.98+$0.12 USD Hold'em No Limit - Level III (25/50) - 2020/05/17 9:38:30 ET
Table '2896837020 67' 9-max Seat #3 is the button
Seat 1: psitorch (2787 in chips)
Seat 2: Tolebi (3000 in chips)
Seat 3: rmooring1 (4139 in chips)
Seat 4: gleb2310 (3371 in chips)
Seat 5: VITALYA$333 (2440 in chips)
Seat 6: SuperQ22 (2673 in chips)
Seat 7: marzocca696969 (2642 in chips)
Seat 8: elketefuka (11266 in chips)
Seat 9: TENSAI POKER (2879 in chips)
psitorch: posts the ante 6
Tolebi: posts the ante 6
rmooring1: posts the ante 6
gleb2310: posts the ante 6
VITALYA$333: posts the ante 6
SuperQ22: posts the ante 6
marzocca696969: posts the ante 6
elketefuka: posts the ante 6
TENSAI POKER: posts the ante 6
gleb2310: posts small blind 25
VITALYA$333: posts big blind 50
*** HOLE CARDS ***
Dealt to elketefuka [Jd 6h]
SuperQ22: folds
marzocca696969: raises 179 to 229
elketefuka: folds
TENSAI POKER: folds
psitorch: folds
Tolebi: calls 229
rmooring1: calls 229
gleb2310: raises 3136 to 3365 and is all-in
VITALYA$333: folds
marzocca696969: calls 2407 and is all-in
Tolebi: folds
rmooring1: folds
Uncalled bet (729) returned to gleb2310
*** FLOP *** [9s Kh 5c]
*** TURN *** [9s Kh 5c] [4h]
*** RIVER *** [9s Kh 5c 4h] [3d]
*** SHOW DOWN ***
gleb2310: shows [Qs Qc] (a pair of Queens)
marzocca696969: shows [Ks Qd] (a pair of Kings)
marzocca696969 collected 5834 from pot
*** SUMMARY ***
Total pot 5834 | Rake 0
Board [9s Kh 5c 4h 3d]
Seat 1: psitorch folded before Flop (didn't bet)
Seat 2: Tolebi folded before Flop
Seat 3: rmooring1 (button) folded before Flop
Seat 4: gleb2310 (small blind) showed [Qs Qc] and lost with a pair of Queens
Seat 5: VITALYA$333 (big blind) folded before Flop
Seat 6: SuperQ22 folded before Flop (didn't bet)
Seat 7: marzocca696969 showed [Ks Qd] and won (5834) with a pair of Kings
Seat 8: elketefuka folded before Flop (didn't bet)
Seat 9: TENSAI POKER folded before Flop (didn't bet)


*********** # 20 **************
PokerStars Hand #214023102620: Tournament #2896837020, $0.98+$0.12 USD Hold'em No Limit - Level III (25/50) - 2020/05/17 9:39:21 ET
Table '2896837020 67' 9-max Seat #4 is the button
Seat 1: psitorch (2781 in chips)
Seat 2: Tolebi (2765 in chips)
Seat 3: rmooring1 (3904 in chips)
Seat 4: gleb2310 (729 in chips)
Seat 5: VITALYA$333 (2384 in chips)
Seat 6: SuperQ22 (2667 in chips)
Seat 7: marzocca696969 (5834 in chips)
Seat 8: elketefuka (11260 in chips)
Seat 9: TENSAI POKER (2873 in chips)
psitorch: posts the ante 6
Tolebi: posts the ante 6
rmooring1: posts the ante 6
gleb2310: posts the ante 6
VITALYA$333: posts the ante 6
SuperQ22: posts the ante 6
marzocca696969: posts the ante 6
elketefuka: posts the ante 6
TENSAI POKER: posts the ante 6
VITALYA$333: posts small blind 25
SuperQ22: posts big blind 50
*** HOLE CARDS ***
Dealt to elketefuka [2d Ks]
marzocca696969: calls 50
elketefuka: folds
TENSAI POKER: folds
psitorch: folds
Tolebi: folds
rmooring1: calls 50
gleb2310: folds
VITALYA$333: folds
SuperQ22: checks
*** FLOP *** [8d 3h 5d]
SuperQ22: checks
marzocca696969: checks
rmooring1: checks
*** TURN *** [8d 3h 5d] [Tc]
SuperQ22: checks
marzocca696969: bets 50
rmooring1: calls 50
SuperQ22: folds
*** RIVER *** [8d 3h 5d Tc] [2s]
marzocca696969: bets 50
rmooring1: raises 50 to 100
marzocca696969: calls 50
*** SHOW DOWN ***
rmooring1: shows [Js Td] (a pair of Tens)
marzocca696969: mucks hand
rmooring1 collected 529 from pot
*** SUMMARY ***
Total pot 529 | Rake 0
Board [8d 3h 5d Tc 2s]
Seat 1: psitorch folded before Flop (didn't bet)
Seat 2: Tolebi folded before Flop (didn't bet)
Seat 3: rmooring1 showed [Js Td] and won (529) with a pair of Tens
Seat 4: gleb2310 (button) folded before Flop (didn't bet)
Seat 5: VITALYA$333 (small blind) folded before Flop
Seat 6: SuperQ22 (big blind) folded on the Turn
Seat 7: marzocca696969 mucked [7c Kc]
Seat 8: elketefuka folded before Flop (didn't bet)
Seat 9: TENSAI POKER folded before Flop (didn't bet)


*********** # 21 **************
PokerStars Hand #214023167429: Tournament #2896837020, $0.98+$0.12 USD Hold'em No Limit - Level III (25/50) - 2020/05/17 9:40:42 ET
Table '2896837020 67' 9-max Seat #5 is the button
Seat 1: psitorch (2775 in chips)
Seat 2: Tolebi (2759 in chips)
Seat 3: rmooring1 (4227 in chips)
Seat 4: gleb2310 (723 in chips)
Seat 5: VITALYA$333 (2353 in chips)
Seat 6: SuperQ22 (2611 in chips)
Seat 7: marzocca696969 (5628 in chips)
Seat 8: elketefuka (11254 in chips)
Seat 9: TENSAI POKER (2867 in chips)
psitorch: posts the ante 6
Tolebi: posts the ante 6
rmooring1: posts the ante 6
gleb2310: posts the ante 6
VITALYA$333: posts the ante 6
SuperQ22: posts the ante 6
marzocca696969: posts the ante 6
elketefuka: posts the ante 6
TENSAI POKER: posts the ante 6
SuperQ22: posts small blind 25
marzocca696969: posts big blind 50
*** HOLE CARDS ***
Dealt to elketefuka [Qs Jc]
elketefuka: raises 100 to 150
TENSAI POKER: folds
psitorch: folds
Tolebi: raises 350 to 500
rmooring1: folds
gleb2310: raises 217 to 717 and is all-in
VITALYA$333: folds
SuperQ22: folds
marzocca696969: calls 667
elketefuka: folds
Tolebi: calls 217
*** FLOP *** [6h Ts 6c]
marzocca696969: checks
Tolebi: checks
*** TURN *** [6h Ts 6c] [Qc]
marzocca696969: checks
Tolebi: checks
*** RIVER *** [6h Ts 6c Qc] [3s]
marzocca696969: checks
Tolebi: checks
*** SHOW DOWN ***
marzocca696969: shows [Ad 2s] (a pair of Sixes)
Tolebi: shows [Ks As] (a pair of Sixes - Ace+King kicker)
gleb2310: mucks hand
Tolebi collected 2380 from pot
gleb2310 finished the tournament in 3703rd place
*** SUMMARY ***
Total pot 2380 | Rake 0
Board [6h Ts 6c Qc 3s]
Seat 1: psitorch folded before Flop (didn't bet)
Seat 2: Tolebi showed [Ks As] and won (2380) with a pair of Sixes
Seat 3: rmooring1 folded before Flop (didn't bet)
Seat 4: gleb2310 mucked [7c Ah]
Seat 5: VITALYA$333 (button) folded before Flop (didn't bet)
Seat 6: SuperQ22 (small blind) folded before Flop
Seat 7: marzocca696969 (big blind) showed [Ad 2s] and lost with a pair of Sixes
Seat 8: elketefuka folded before Flop
Seat 9: TENSAI POKER folded before Flop (didn't bet)


*********** # 22 **************
PokerStars Hand #214023214509: Tournament #2896837020, $0.98+$0.12 USD Hold'em No Limit - Level III (25/50) - 2020/05/17 9:41:47 ET
Table '2896837020 67' 9-max Seat #6 is the button
Seat 1: psitorch (2769 in chips)
Seat 2: Tolebi (4416 in chips)
Seat 3: rmooring1 (4221 in chips)
Seat 5: VITALYA$333 (2347 in chips)
Seat 6: SuperQ22 (2580 in chips)
Seat 7: marzocca696969 (4905 in chips)
Seat 8: elketefuka (11098 in chips)
Seat 9: TENSAI POKER (2861 in chips)
psitorch: posts the ante 6
Tolebi: posts the ante 6
rmooring1: posts the ante 6
VITALYA$333: posts the ante 6
SuperQ22: posts the ante 6
marzocca696969: posts the ante 6
elketefuka: posts the ante 6
TENSAI POKER: posts the ante 6
marzocca696969: posts small blind 25
elketefuka: posts big blind 50
*** HOLE CARDS ***
Dealt to elketefuka [Kh 4s]
TENSAI POKER: folds
psitorch: raises 77 to 127
Tolebi: raises 273 to 400
rmooring1: folds
VITALYA$333: folds
SuperQ22: folds
marzocca696969: folds
elketefuka: folds
psitorch: folds
Uncalled bet (273) returned to Tolebi
Tolebi collected 377 from pot
*** SUMMARY ***
Total pot 377 | Rake 0
Seat 1: psitorch folded before Flop
Seat 2: Tolebi collected (377)
Seat 3: rmooring1 folded before Flop (didn't bet)
Seat 5: VITALYA$333 folded before Flop (didn't bet)
Seat 6: SuperQ22 (button) folded before Flop (didn't bet)
Seat 7: marzocca696969 (small blind) folded before Flop
Seat 8: elketefuka (big blind) folded before Flop
Seat 9: TENSAI POKER folded before Flop (didn't bet)


*********** # 23 **************
PokerStars Hand #214023246278: Tournament #2896837020, $0.98+$0.12 USD Hold'em No Limit - Level III (25/50) - 2020/05/17 9:42:30 ET
Table '2896837020 67' 9-max Seat #7 is the button
Seat 1: psitorch (2636 in chips)
Seat 2: Tolebi (4660 in chips)
Seat 3: rmooring1 (4215 in chips)
Seat 4: pilifish (3000 in chips)
Seat 5: VITALYA$333 (2341 in chips)
Seat 6: SuperQ22 (2574 in chips)
Seat 7: marzocca696969 (4874 in chips)
Seat 8: elketefuka (11042 in chips)
Seat 9: TENSAI POKER (2855 in chips)
psitorch: posts the ante 6
Tolebi: posts the ante 6
rmooring1: posts the ante 6
pilifish: posts the ante 6
VITALYA$333: posts the ante 6
SuperQ22: posts the ante 6
marzocca696969: posts the ante 6
elketefuka: posts the ante 6
TENSAI POKER: posts the ante 6
elketefuka: posts small blind 25
TENSAI POKER: posts big blind 50
*** HOLE CARDS ***
Dealt to elketefuka [7h 9h]
psitorch: folds
Tolebi: calls 50
rmooring1: calls 50
pilifish: folds
VITALYA$333: folds
SuperQ22: folds
marzocca696969: calls 50
elketefuka: calls 25
TENSAI POKER: checks
*** FLOP *** [7s Kc 8c]
elketefuka: checks
TENSAI POKER: checks
Tolebi: bets 100
rmooring1: folds
marzocca696969: folds
elketefuka: calls 100
TENSAI POKER: calls 100
*** TURN *** [7s Kc 8c] [9d]
elketefuka: checks
TENSAI POKER: checks
Tolebi: bets 250
elketefuka: raises 850 to 1100
TENSAI POKER: folds
Tolebi: calls 850
*** RIVER *** [7s Kc 8c 9d] [3h]
elketefuka: bets 1550
Tolebi: calls 1550
*** SHOW DOWN ***
elketefuka: shows [7h 9h] (two pair, Nines and Sevens)
Tolebi: mucks hand
elketefuka collected 5904 from pot
*** SUMMARY ***
Total pot 5904 | Rake 0
Board [7s Kc 8c 9d 3h]
Seat 1: psitorch folded before Flop (didn't bet)
Seat 2: Tolebi mucked [Qs Qd]
Seat 3: rmooring1 folded on the Flop
Seat 4: pilifish folded before Flop (didn't bet)
Seat 5: VITALYA$333 folded before Flop (didn't bet)
Seat 6: SuperQ22 folded before Flop (didn't bet)
Seat 7: marzocca696969 (button) folded on the Flop
Seat 8: elketefuka (small blind) showed [7h 9h] and won (5904) with two pair, Nines and Sevens
Seat 9: TENSAI POKER (big blind) folded on the Turn


*********** # 24 **************
PokerStars Hand #214023354141: Tournament #2896837020, $0.98+$0.12 USD Hold'em No Limit - Level III (25/50) - 2020/05/17 9:44:50 ET
Table '2896837020 67' 9-max Seat #8 is the button
Seat 1: psitorch (2630 in chips)
Seat 2: Tolebi (1854 in chips)
Seat 3: rmooring1 (4159 in chips)
Seat 4: pilifish (2994 in chips)
Seat 5: VITALYA$333 (2335 in chips)
Seat 6: SuperQ22 (2568 in chips)
Seat 7: marzocca696969 (4818 in chips)
Seat 8: elketefuka (14140 in chips)
Seat 9: TENSAI POKER (2699 in chips)
psitorch: posts the ante 6
Tolebi: posts the ante 6
rmooring1: posts the ante 6
pilifish: posts the ante 6
VITALYA$333: posts the ante 6
SuperQ22: posts the ante 6
marzocca696969: posts the ante 6
elketefuka: posts the ante 6
TENSAI POKER: posts the ante 6
TENSAI POKER: posts small blind 25
psitorch: posts big blind 50
*** HOLE CARDS ***
Dealt to elketefuka [9s 4d]
Tolebi: folds
rmooring1: calls 50
pilifish: folds
VITALYA$333: folds
SuperQ22: raises 150 to 200
marzocca696969: calls 200
elketefuka: folds
TENSAI POKER: folds
psitorch: folds
rmooring1: calls 150
*** FLOP *** [4s 7h 5c]
rmooring1: bets 150
SuperQ22: folds
marzocca696969: raises 500 to 650
rmooring1: folds
Uncalled bet (500) returned to marzocca696969
marzocca696969 collected 1029 from pot
marzocca696969: doesn't show hand
*** SUMMARY ***
Total pot 1029 | Rake 0
Board [4s 7h 5c]
Seat 1: psitorch (big blind) folded before Flop
Seat 2: Tolebi folded before Flop (didn't bet)
Seat 3: rmooring1 folded on the Flop
Seat 4: pilifish folded before Flop (didn't bet)
Seat 5: VITALYA$333 folded before Flop (didn't bet)
Seat 6: SuperQ22 folded on the Flop
Seat 7: marzocca696969 collected (1029)
Seat 8: elketefuka (button) folded before Flop (didn't bet)
Seat 9: TENSAI POKER (small blind) folded before Flop


*********** # 25 **************
PokerStars Hand #214023400319: Tournament #2896837020, $0.98+$0.12 USD Hold'em No Limit - Level IV (30/60) - 2020/05/17 9:45:53 ET
Table '2896837020 67' 9-max Seat #9 is the button
Seat 1: psitorch (2574 in chips)
Seat 2: Tolebi (1848 in chips)
Seat 3: rmooring1 (3803 in chips)
Seat 4: pilifish (2988 in chips)
Seat 5: VITALYA$333 (2329 in chips)
Seat 6: SuperQ22 (2362 in chips)
Seat 7: marzocca696969 (5491 in chips)
Seat 8: elketefuka (14134 in chips)
Seat 9: TENSAI POKER (2668 in chips)
psitorch: posts the ante 7
Tolebi: posts the ante 7
rmooring1: posts the ante 7
pilifish: posts the ante 7
VITALYA$333: posts the ante 7
SuperQ22: posts the ante 7
marzocca696969: posts the ante 7
elketefuka: posts the ante 7
TENSAI POKER: posts the ante 7
psitorch: posts small blind 30
Tolebi: posts big blind 60
*** HOLE CARDS ***
Dealt to elketefuka [Tc Qd]
rmooring1: calls 60
pilifish: folds
VITALYA$333: raises 180 to 240
SuperQ22: folds
marzocca696969: folds
elketefuka: calls 240
TENSAI POKER: folds
psitorch: folds
Tolebi: calls 180
rmooring1: calls 180
*** FLOP *** [Td 9c 2d]
Tolebi: checks
rmooring1: checks
VITALYA$333: checks
elketefuka: bets 560
Tolebi: folds
rmooring1: folds
VITALYA$333: raises 1522 to 2082 and is all-in
elketefuka: calls 1522
*** TURN *** [Td 9c 2d] [Ts]
*** RIVER *** [Td 9c 2d Ts] [7c]
*** SHOW DOWN ***
VITALYA$333: shows [Js Qs] (a pair of Tens)
elketefuka: shows [Tc Qd] (three of a kind, Tens)
elketefuka collected 5217 from pot
VITALYA$333 finished the tournament in 3599th place
*** SUMMARY ***
Total pot 5217 | Rake 0
Board [Td 9c 2d Ts 7c]
Seat 1: psitorch (small blind) folded before Flop
Seat 2: Tolebi (big blind) folded on the Flop
Seat 3: rmooring1 folded on the Flop
Seat 4: pilifish folded before Flop (didn't bet)
Seat 5: VITALYA$333 showed [Js Qs] and lost with a pair of Tens
Seat 6: SuperQ22 folded before Flop (didn't bet)
Seat 7: marzocca696969 folded before Flop (didn't bet)
Seat 8: elketefuka showed [Tc Qd] and won (5217) with three of a kind, Tens
Seat 9: TENSAI POKER (button) folded before Flop (didn't bet)


*********** # 26 **************
PokerStars Hand #214023469179: Tournament #2896837020, $0.98+$0.12 USD Hold'em No Limit - Level IV (30/60) - 2020/05/17 9:47:27 ET
Table '2896837020 67' 9-max Seat #1 is the button
Seat 1: psitorch (2537 in chips)
Seat 2: Tolebi (1601 in chips)
Seat 3: rmooring1 (3556 in chips)
Seat 4: pilifish (2981 in chips)
Seat 6: SuperQ22 (2355 in chips)
Seat 7: marzocca696969 (5484 in chips)
Seat 8: elketefuka (17022 in chips)
Seat 9: TENSAI POKER (2661 in chips)
psitorch: posts the ante 7
Tolebi: posts the ante 7
rmooring1: posts the ante 7
pilifish: posts the ante 7
SuperQ22: posts the ante 7
marzocca696969: posts the ante 7
elketefuka: posts the ante 7
TENSAI POKER: posts the ante 7
Tolebi: posts small blind 30
rmooring1: posts big blind 60
*** HOLE CARDS ***
Dealt to elketefuka [Jc As]
pilifish: folds
SuperQ22: folds
marzocca696969: folds
elketefuka: calls 60
TENSAI POKER: folds
psitorch: folds
Tolebi: raises 120 to 180
rmooring1: calls 120
elketefuka: calls 120
*** FLOP *** [Tc 4s 5c]
Tolebi: checks
rmooring1: bets 60
elketefuka: calls 60
Tolebi: raises 300 to 360
rmooring1: calls 300
elketefuka: folds
*** TURN *** [Tc 4s 5c] [8d]
Tolebi: bets 1054 and is all-in
rmooring1: calls 1054
*** RIVER *** [Tc 4s 5c 8d] [Js]
*** SHOW DOWN ***
Tolebi: shows [Ah Jd] (a pair of Jacks)
rmooring1: shows [Th Ks] (a pair of Tens)
Tolebi collected 3484 from pot
*** SUMMARY ***
Total pot 3484 | Rake 0
Board [Tc 4s 5c 8d Js]
Seat 1: psitorch (button) folded before Flop (didn't bet)
Seat 2: Tolebi (small blind) showed [Ah Jd] and won (3484) with a pair of Jacks
Seat 3: rmooring1 (big blind) showed [Th Ks] and lost with a pair of Tens
Seat 4: pilifish folded before Flop (didn't bet)
Seat 6: SuperQ22 folded before Flop (didn't bet)
Seat 7: marzocca696969 folded before Flop (didn't bet)
Seat 8: elketefuka folded on the Flop
Seat 9: TENSAI POKER folded before Flop (didn't bet)


*********** # 27 **************
PokerStars Hand #214023522875: Tournament #2896837020, $0.98+$0.12 USD Hold'em No Limit - Level IV (30/60) - 2020/05/17 9:48:40 ET
Table '2896837020 67' 9-max Seat #2 is the button
Seat 1: psitorch (2530 in chips)
Seat 2: Tolebi (3484 in chips)
Seat 3: rmooring1 (1955 in chips)
Seat 4: pilifish (2974 in chips)
Seat 5: Tolins500 (3000 in chips)
Seat 6: SuperQ22 (2348 in chips)
Seat 7: marzocca696969 (5477 in chips)
Seat 8: elketefuka (16775 in chips)
Seat 9: TENSAI POKER (2654 in chips)
psitorch: posts the ante 7
Tolebi: posts the ante 7
rmooring1: posts the ante 7
pilifish: posts the ante 7
Tolins500: posts the ante 7
SuperQ22: posts the ante 7
marzocca696969: posts the ante 7
elketefuka: posts the ante 7
TENSAI POKER: posts the ante 7
rmooring1: posts small blind 30
pilifish: posts big blind 60
*** HOLE CARDS ***
Dealt to elketefuka [8d Ad]
Tolins500: folds
SuperQ22: folds
marzocca696969: raises 60 to 120
elketefuka: calls 120
TENSAI POKER: folds
psitorch: folds
Tolebi: calls 120
rmooring1: folds
pilifish: calls 60
*** FLOP *** [3h 9h Qs]
pilifish: checks
marzocca696969: bets 300
elketefuka: folds
Tolebi: calls 300
pilifish: folds
*** TURN *** [3h 9h Qs] [2s]
marzocca696969: bets 1200
Tolebi: folds
Uncalled bet (1200) returned to marzocca696969
marzocca696969 collected 1173 from pot
marzocca696969: doesn't show hand
*** SUMMARY ***
Total pot 1173 | Rake 0
Board [3h 9h Qs 2s]
Seat 1: psitorch folded before Flop (didn't bet)
Seat 2: Tolebi (button) folded on the Turn
Seat 3: rmooring1 (small blind) folded before Flop
Seat 4: pilifish (big blind) folded on the Flop
Seat 5: Tolins500 folded before Flop (didn't bet)
Seat 6: SuperQ22 folded before Flop (didn't bet)
Seat 7: marzocca696969 collected (1173)
Seat 8: elketefuka folded on the Flop
Seat 9: TENSAI POKER folded before Flop (didn't bet)


*********** # 28 **************
PokerStars Hand #214023583007: Tournament #2896837020, $0.98+$0.12 USD Hold'em No Limit - Level IV (30/60) - 2020/05/17 9:50:01 ET
Table '2896837020 67' 9-max Seat #3 is the button
Seat 1: psitorch (2523 in chips)
Seat 2: Tolebi (3057 in chips)
Seat 3: rmooring1 (1918 in chips)
Seat 4: pilifish (2847 in chips)
Seat 5: Tolins500 (2993 in chips)
Seat 6: SuperQ22 (2341 in chips)
Seat 7: marzocca696969 (6223 in chips)
Seat 8: elketefuka (16648 in chips)
Seat 9: TENSAI POKER (2647 in chips)
psitorch: posts the ante 7
Tolebi: posts the ante 7
rmooring1: posts the ante 7
pilifish: posts the ante 7
Tolins500: posts the ante 7
SuperQ22: posts the ante 7
marzocca696969: posts the ante 7
elketefuka: posts the ante 7
TENSAI POKER: posts the ante 7
pilifish: posts small blind 30
Tolins500: posts big blind 60
*** HOLE CARDS ***
Dealt to elketefuka [Jd Qd]
SuperQ22: folds
marzocca696969: calls 60
elketefuka: raises 120 to 180
TENSAI POKER: folds
psitorch: folds
Tolebi: folds
rmooring1: calls 180
pilifish: folds
Tolins500: calls 120
marzocca696969: calls 120
*** FLOP *** [5d Kh Th]
Tolins500: checks
marzocca696969: checks
elketefuka: bets 407
rmooring1: folds
Tolins500: folds
marzocca696969: folds
Uncalled bet (407) returned to elketefuka
elketefuka collected 813 from pot
elketefuka: doesn't show hand
*** SUMMARY ***
Total pot 813 | Rake 0
Board [5d Kh Th]
Seat 1: psitorch folded before Flop (didn't bet)
Seat 2: Tolebi folded before Flop (didn't bet)
Seat 3: rmooring1 (button) folded on the Flop
Seat 4: pilifish (small blind) folded before Flop
Seat 5: Tolins500 (big blind) folded on the Flop
Seat 6: SuperQ22 folded before Flop (didn't bet)
Seat 7: marzocca696969 folded on the Flop
Seat 8: elketefuka collected (813)
Seat 9: TENSAI POKER folded before Flop (didn't bet)


*********** # 29 **************
PokerStars Hand #214023638477: Tournament #2896837020, $0.98+$0.12 USD Hold'em No Limit - Level IV (30/60) - 2020/05/17 9:51:16 ET
Table '2896837020 67' 9-max Seat #4 is the button
Seat 1: psitorch (2516 in chips)
Seat 2: Tolebi (3050 in chips)
Seat 3: rmooring1 (1731 in chips)
Seat 4: pilifish (2810 in chips)
Seat 5: Tolins500 (2806 in chips)
Seat 6: SuperQ22 (2334 in chips)
Seat 7: marzocca696969 (6036 in chips)
Seat 8: elketefuka (17274 in chips)
Seat 9: TENSAI POKER (2640 in chips)
psitorch: posts the ante 7
Tolebi: posts the ante 7
rmooring1: posts the ante 7
pilifish: posts the ante 7
Tolins500: posts the ante 7
SuperQ22: posts the ante 7
marzocca696969: posts the ante 7
elketefuka: posts the ante 7
TENSAI POKER: posts the ante 7
Tolins500: posts small blind 30
SuperQ22: posts big blind 60
*** HOLE CARDS ***
Dealt to elketefuka [6c 5h]
marzocca696969: calls 60
elketefuka: folds
TENSAI POKER: folds
psitorch: folds
Tolebi: folds
rmooring1: calls 60
pilifish: folds
Tolins500: calls 30
SuperQ22: checks
*** FLOP *** [4c 8d 8s]
Tolins500: bets 120
SuperQ22: folds
marzocca696969 has timed out
marzocca696969: folds
marzocca696969 is sitting out
marzocca696969 has returned
rmooring1: calls 120
*** TURN *** [4c 8d 8s] [3s]
Tolins500: bets 180
rmooring1: raises 180 to 360
Tolins500: calls 180
*** RIVER *** [4c 8d 8s 3s] [5s]
Tolins500: checks
rmooring1: bets 632
Tolins500: folds
Uncalled bet (632) returned to rmooring1
rmooring1 collected 1263 from pot
rmooring1: doesn't show hand
*** SUMMARY ***
Total pot 1263 | Rake 0
Board [4c 8d 8s 3s 5s]
Seat 1: psitorch folded before Flop (didn't bet)
Seat 2: Tolebi folded before Flop (didn't bet)
Seat 3: rmooring1 collected (1263)
Seat 4: pilifish (button) folded before Flop (didn't bet)
Seat 5: Tolins500 (small blind) folded on the River
Seat 6: SuperQ22 (big blind) folded on the Flop
Seat 7: marzocca696969 folded on the Flop
Seat 8: elketefuka folded before Flop (didn't bet)
Seat 9: TENSAI POKER folded before Flop (didn't bet)


*********** # 30 **************
PokerStars Hand #214023750742: Tournament #2896837020, $0.98+$0.12 USD Hold'em No Limit - Level IV (30/60) - 2020/05/17 9:53:48 ET
Table '2896837020 67' 9-max Seat #5 is the button
Seat 1: psitorch (2509 in chips)
Seat 2: Tolebi (3043 in chips)
Seat 3: rmooring1 (2447 in chips)
Seat 4: pilifish (2803 in chips)
Seat 5: Tolins500 (2259 in chips)
Seat 6: SuperQ22 (2267 in chips)
Seat 7: marzocca696969 (5969 in chips)
Seat 8: elketefuka (17267 in chips)
Seat 9: TENSAI POKER (2633 in chips)
psitorch: posts the ante 7
Tolebi: posts the ante 7
rmooring1: posts the ante 7
pilifish: posts the ante 7
Tolins500: posts the ante 7
SuperQ22: posts the ante 7
marzocca696969: posts the ante 7
elketefuka: posts the ante 7
TENSAI POKER: posts the ante 7
SuperQ22: posts small blind 30
marzocca696969: posts big blind 60
*** HOLE CARDS ***
Dealt to elketefuka [8d Ts]
elketefuka: folds
TENSAI POKER: raises 90 to 150
psitorch: folds
Tolebi: calls 150
rmooring1: calls 150
pilifish: folds
Tolins500: folds
SuperQ22: folds
marzocca696969: calls 90
*** FLOP *** [Th Tc 8s]
marzocca696969: bets 360
TENSAI POKER: calls 360
Tolebi: folds
rmooring1: raises 1930 to 2290 and is all-in
marzocca696969: folds
TENSAI POKER: calls 1930
*** TURN *** [Th Tc 8s] [Qc]
*** RIVER *** [Th Tc 8s Qc] [4s]
*** SHOW DOWN ***
TENSAI POKER: shows [Td Jd] (three of a kind, Tens)
rmooring1: shows [5h As] (a pair of Tens)
TENSAI POKER collected 5633 from pot
rmooring1 finished the tournament in 3424th place
*** SUMMARY ***
Total pot 5633 | Rake 0
Board [Th Tc 8s Qc 4s]
Seat 1: psitorch folded before Flop (didn't bet)
Seat 2: Tolebi folded on the Flop
Seat 3: rmooring1 showed [5h As] and lost with a pair of Tens
Seat 4: pilifish folded before Flop (didn't bet)
Seat 5: Tolins500 (button) folded before Flop (didn't bet)
Seat 6: SuperQ22 (small blind) folded before Flop
Seat 7: marzocca696969 (big blind) folded on the Flop
Seat 8: elketefuka folded before Flop (didn't bet)
Seat 9: TENSAI POKER showed [Td Jd] and won (5633) with three of a kind, Tens


*********** # 31 **************
PokerStars Hand #214023798284: Tournament #2896837020, $0.98+$0.12 USD Hold'em No Limit - Level IV (30/60) - 2020/05/17 9:54:53 ET
Table '2896837020 67' 9-max Seat #6 is the button
Seat 1: psitorch (2502 in chips)
Seat 2: Tolebi (2886 in chips)
Seat 4: pilifish (2796 in chips)
Seat 5: Tolins500 (2252 in chips)
Seat 6: SuperQ22 (2230 in chips)
Seat 7: marzocca696969 (5452 in chips)
Seat 8: elketefuka (17260 in chips)
Seat 9: TENSAI POKER (5819 in chips)
psitorch: posts the ante 7
Tolebi: posts the ante 7
pilifish: posts the ante 7
Tolins500: posts the ante 7
SuperQ22: posts the ante 7
marzocca696969: posts the ante 7
elketefuka: posts the ante 7
TENSAI POKER: posts the ante 7
marzocca696969: posts small blind 30
elketefuka: posts big blind 60
*** HOLE CARDS ***
Dealt to elketefuka [8s 4h]
TENSAI POKER: folds
psitorch: folds
Tolebi: folds
pilifish: raises 90 to 150
Tolins500: calls 150
SuperQ22: folds
marzocca696969: calls 120
elketefuka: calls 90
*** FLOP *** [4s 9s 8h]
marzocca696969: checks
elketefuka: bets 460
pilifish: folds
Tolins500: folds
marzocca696969: folds
Uncalled bet (460) returned to elketefuka
elketefuka collected 656 from pot
elketefuka: doesn't show hand
*** SUMMARY ***
Total pot 656 | Rake 0
Board [4s 9s 8h]
Seat 1: psitorch folded before Flop (didn't bet)
Seat 2: Tolebi folded before Flop (didn't bet)
Seat 4: pilifish folded on the Flop
Seat 5: Tolins500 folded on the Flop
Seat 6: SuperQ22 (button) folded before Flop (didn't bet)
Seat 7: marzocca696969 (small blind) folded on the Flop
Seat 8: elketefuka (big blind) collected (656)
Seat 9: TENSAI POKER folded before Flop (didn't bet)


*********** # 32 **************
PokerStars Hand #214024036428: Tournament #2896837020, $0.98+$0.12 USD Hold'em No Limit - Level IV (30/60) - 2020/05/17 10:01:45 ET
Table '2896837020 67' 9-max Seat #7 is the button
Seat 1: psitorch (2495 in chips)
Seat 2: Tolebi (2879 in chips)
Seat 3: Cherep1993 (3000 in chips)
Seat 4: pilifish (2639 in chips)
Seat 5: Tolins500 (2095 in chips)
Seat 6: SuperQ22 (2223 in chips)
Seat 7: marzocca696969 (5295 in chips)
Seat 8: elketefuka (17759 in chips)
Seat 9: TENSAI POKER (5812 in chips)
psitorch: posts the ante 7
Tolebi: posts the ante 7
Cherep1993: posts the ante 7
pilifish: posts the ante 7
Tolins500: posts the ante 7
SuperQ22: posts the ante 7
marzocca696969: posts the ante 7
elketefuka: posts the ante 7
TENSAI POKER: posts the ante 7
elketefuka: posts small blind 30
TENSAI POKER: posts big blind 60
*** HOLE CARDS ***
Dealt to elketefuka [4c 5d]
psitorch: folds
Tolebi: folds
Cherep1993: folds
pilifish: calls 60
Tolins500: calls 60
SuperQ22: folds
marzocca696969: raises 60 to 120
elketefuka: folds
TENSAI POKER: calls 60
pilifish: calls 60
Tolins500: calls 60
*** FLOP *** [7h Kh 9s]
TENSAI POKER: checks
pilifish: checks
Tolins500: checks
marzocca696969: bets 600
TENSAI POKER: folds
pilifish: folds
Tolins500: folds
Uncalled bet (600) returned to marzocca696969
marzocca696969 collected 573 from pot
marzocca696969: doesn't show hand
*** SUMMARY ***
Total pot 573 | Rake 0
Board [7h Kh 9s]
Seat 1: psitorch folded before Flop (didn't bet)
Seat 2: Tolebi folded before Flop (didn't bet)
Seat 3: Cherep1993 folded before Flop (didn't bet)
Seat 4: pilifish folded on the Flop
Seat 5: Tolins500 folded on the Flop
Seat 6: SuperQ22 folded before Flop (didn't bet)
Seat 7: marzocca696969 (button) collected (573)
Seat 8: elketefuka (small blind) folded before Flop
Seat 9: TENSAI POKER (big blind) folded on the Flop


*********** # 33 **************
PokerStars Hand #214024113933: Tournament #2896837020, $0.98+$0.12 USD Hold'em No Limit - Level V (40/80) - 2020/05/17 10:03:32 ET
Table '2896837020 67' 9-max Seat #8 is the button
Seat 1: psitorch (2488 in chips)
Seat 2: Tolebi (2872 in chips)
Seat 3: Cherep1993 (2993 in chips)
Seat 4: pilifish (2512 in chips)
Seat 5: Tolins500 (1968 in chips)
Seat 6: SuperQ22 (2216 in chips)
Seat 7: marzocca696969 (5741 in chips)
Seat 8: elketefuka (17722 in chips)
Seat 9: TENSAI POKER (5685 in chips)
psitorch: posts the ante 10
Tolebi: posts the ante 10
Cherep1993: posts the ante 10
pilifish: posts the ante 10
Tolins500: posts the ante 10
SuperQ22: posts the ante 10
marzocca696969: posts the ante 10
elketefuka: posts the ante 10
TENSAI POKER: posts the ante 10
TENSAI POKER: posts small blind 40
psitorch: posts big blind 80
*** HOLE CARDS ***
Dealt to elketefuka [Td Qc]
Tolebi: folds
Cherep1993: folds
pilifish: folds
Tolins500: raises 80 to 160
SuperQ22: folds
marzocca696969: folds
elketefuka: calls 160
TENSAI POKER: folds
psitorch: folds
*** FLOP *** [9h 7h Qh]
Tolins500: bets 320
elketefuka: calls 320
*** TURN *** [9h 7h Qh] [5h]
Tolins500: bets 400
elketefuka: folds
Uncalled bet (400) returned to Tolins500
Tolins500 collected 1170 from pot
*** SUMMARY ***
Total pot 1170 | Rake 0
Board [9h 7h Qh 5h]
Seat 1: psitorch (big blind) folded before Flop
Seat 2: Tolebi folded before Flop (didn't bet)
Seat 3: Cherep1993 folded before Flop (didn't bet)
Seat 4: pilifish folded before Flop (didn't bet)
Seat 5: Tolins500 collected (1170)
Seat 6: SuperQ22 folded before Flop (didn't bet)
Seat 7: marzocca696969 folded before Flop (didn't bet)
Seat 8: elketefuka (button) folded on the Turn
Seat 9: TENSAI POKER (small blind) folded before Flop


*********** # 34 **************
PokerStars Hand #214024164375: Tournament #2896837020, $0.98+$0.12 USD Hold'em No Limit - Level V (40/80) - 2020/05/17 10:04:39 ET
Table '2896837020 67' 9-max Seat #9 is the button
Seat 1: psitorch (2398 in chips)
Seat 2: Tolebi (2862 in chips)
Seat 3: Cherep1993 (2983 in chips)
Seat 4: pilifish (2502 in chips)
Seat 5: Tolins500 (2648 in chips)
Seat 6: SuperQ22 (2206 in chips)
Seat 7: marzocca696969 (5731 in chips)
Seat 8: elketefuka (17232 in chips)
Seat 9: TENSAI POKER (5635 in chips)
psitorch: posts the ante 10
Tolebi: posts the ante 10
Cherep1993: posts the ante 10
pilifish: posts the ante 10
Tolins500: posts the ante 10
SuperQ22: posts the ante 10
marzocca696969: posts the ante 10
elketefuka: posts the ante 10
TENSAI POKER: posts the ante 10
psitorch: posts small blind 40
Tolebi: posts big blind 80
*** HOLE CARDS ***
Dealt to elketefuka [Qd Jh]
Cherep1993: folds
pilifish: folds
Tolins500: folds
SuperQ22: folds
marzocca696969 has timed out
marzocca696969: folds
marzocca696969 is sitting out
elketefuka: raises 80 to 160
marzocca696969 has returned
TENSAI POKER: raises 400 to 560
psitorch: folds
Tolebi: folds
elketefuka: folds
Uncalled bet (400) returned to TENSAI POKER
TENSAI POKER collected 530 from pot
*** SUMMARY ***
Total pot 530 | Rake 0
Seat 1: psitorch (small blind) folded before Flop
Seat 2: Tolebi (big blind) folded before Flop
Seat 3: Cherep1993 folded before Flop (didn't bet)
Seat 4: pilifish folded before Flop (didn't bet)
Seat 5: Tolins500 folded before Flop (didn't bet)
Seat 6: SuperQ22 folded before Flop (didn't bet)
Seat 7: marzocca696969 folded before Flop (didn't bet)
Seat 8: elketefuka folded before Flop
Seat 9: TENSAI POKER (button) collected (530)


*********** # 35 **************
PokerStars Hand #214024206463: Tournament #2896837020, $0.98+$0.12 USD Hold'em No Limit - Level V (40/80) - 2020/05/17 10:05:34 ET
Table '2896837020 67' 9-max Seat #1 is the button
Seat 1: psitorch (2348 in chips)
Seat 2: Tolebi (2772 in chips)
Seat 3: Cherep1993 (2973 in chips)
Seat 4: pilifish (2492 in chips)
Seat 5: Tolins500 (2638 in chips)
Seat 6: SuperQ22 (2196 in chips)
Seat 7: marzocca696969 (5721 in chips)
Seat 8: elketefuka (17062 in chips)
Seat 9: TENSAI POKER (5995 in chips)
psitorch: posts the ante 10
Tolebi: posts the ante 10
Cherep1993: posts the ante 10
pilifish: posts the ante 10
Tolins500: posts the ante 10
SuperQ22: posts the ante 10
marzocca696969: posts the ante 10
elketefuka: posts the ante 10
TENSAI POKER: posts the ante 10
Tolebi: posts small blind 40
Cherep1993: posts big blind 80
*** HOLE CARDS ***
Dealt to elketefuka [9h 6c]
pilifish: folds
Tolins500: raises 80 to 160
SuperQ22: folds
marzocca696969: folds
elketefuka: folds
TENSAI POKER: folds
psitorch: folds
Tolebi: folds
Cherep1993: calls 80
*** FLOP *** [Jc Ad Qs]
Cherep1993: checks
Tolins500: bets 240
Cherep1993: calls 240
*** TURN *** [Jc Ad Qs] [6h]
Cherep1993: checks
Tolins500: bets 560
Cherep1993: calls 560
*** RIVER *** [Jc Ad Qs 6h] [2d]
Cherep1993: checks
Tolins500: checks
*** SHOW DOWN ***
Cherep1993: shows [Js 4s] (a pair of Jacks)
Tolins500: mucks hand
Cherep1993 collected 2050 from pot
*** SUMMARY ***
Total pot 2050 | Rake 0
Board [Jc Ad Qs 6h 2d]
Seat 1: psitorch (button) folded before Flop (didn't bet)
Seat 2: Tolebi (small blind) folded before Flop
Seat 3: Cherep1993 (big blind) showed [Js 4s] and won (2050) with a pair of Jacks
Seat 4: pilifish folded before Flop (didn't bet)
Seat 5: Tolins500 mucked [Tc 9c]
Seat 6: SuperQ22 folded before Flop (didn't bet)
Seat 7: marzocca696969 folded before Flop (didn't bet)
Seat 8: elketefuka folded before Flop (didn't bet)
Seat 9: TENSAI POKER folded before Flop (didn't bet)


*********** # 36 **************
PokerStars Hand #214024260636: Tournament #2896837020, $0.98+$0.12 USD Hold'em No Limit - Level V (40/80) - 2020/05/17 10:06:45 ET
Table '2896837020 67' 9-max Seat #2 is the button
Seat 1: psitorch (2338 in chips)
Seat 2: Tolebi (2722 in chips)
Seat 3: Cherep1993 (4053 in chips)
Seat 4: pilifish (2482 in chips)
Seat 5: Tolins500 (1668 in chips)
Seat 6: SuperQ22 (2186 in chips)
Seat 7: marzocca696969 (5711 in chips)
Seat 8: elketefuka (17052 in chips)
Seat 9: TENSAI POKER (5985 in chips)
psitorch: posts the ante 10
Tolebi: posts the ante 10
Cherep1993: posts the ante 10
pilifish: posts the ante 10
Tolins500: posts the ante 10
SuperQ22: posts the ante 10
marzocca696969: posts the ante 10
elketefuka: posts the ante 10
TENSAI POKER: posts the ante 10
Cherep1993: posts small blind 40
pilifish: posts big blind 80
*** HOLE CARDS ***
Dealt to elketefuka [Th As]
Tolins500: folds
SuperQ22: folds
marzocca696969: folds
elketefuka: raises 160 to 240
TENSAI POKER: folds
psitorch: folds
Tolebi: calls 240
Cherep1993: folds
pilifish: folds
*** FLOP *** [5h 4h 8h]
elketefuka: bets 345
Tolebi: raises 2127 to 2472 and is all-in
elketefuka: calls 2127
*** TURN *** [5h 4h 8h] [6d]
*** RIVER *** [5h 4h 8h 6d] [Ad]
*** SHOW DOWN ***
elketefuka: shows [Th As] (a pair of Aces)
Tolebi: shows [Ah 9d] (a pair of Aces - lower kicker)
elketefuka collected 5634 from pot
Tolebi finished the tournament in 3284th place
*** SUMMARY ***
Total pot 5634 | Rake 0
Board [5h 4h 8h 6d Ad]
Seat 1: psitorch folded before Flop (didn't bet)
Seat 2: Tolebi (button) showed [Ah 9d] and lost with a pair of Aces
Seat 3: Cherep1993 (small blind) folded before Flop
Seat 4: pilifish (big blind) folded before Flop
Seat 5: Tolins500 folded before Flop (didn't bet)
Seat 6: SuperQ22 folded before Flop (didn't bet)
Seat 7: marzocca696969 folded before Flop (didn't bet)
Seat 8: elketefuka showed [Th As] and won (5634) with a pair of Aces
Seat 9: TENSAI POKER folded before Flop (didn't bet)


*********** # 37 **************
PokerStars Hand #214024299573: Tournament #2896837020, $0.98+$0.12 USD Hold'em No Limit - Level V (40/80) - 2020/05/17 10:07:29 ET
Table '2896837020 67' 9-max Seat #3 is the button
Seat 1: psitorch (2328 in chips)
Seat 3: Cherep1993 (4003 in chips)
Seat 4: pilifish (2392 in chips)
Seat 5: Tolins500 (1658 in chips)
Seat 6: SuperQ22 (2176 in chips)
Seat 7: marzocca696969 (5701 in chips)
Seat 8: elketefuka (19964 in chips)
Seat 9: TENSAI POKER (5975 in chips)
psitorch: posts the ante 10
Cherep1993: posts the ante 10
pilifish: posts the ante 10
Tolins500: posts the ante 10
SuperQ22: posts the ante 10
marzocca696969: posts the ante 10
elketefuka: posts the ante 10
TENSAI POKER: posts the ante 10
pilifish: posts small blind 40
Tolins500: posts big blind 80
*** HOLE CARDS ***
Dealt to elketefuka [3s 7d]
SuperQ22: folds
marzocca696969 has timed out
marzocca696969: folds
marzocca696969 is sitting out
elketefuka: folds
marzocca696969 has returned
TENSAI POKER: folds
psitorch: raises 124 to 204
Cherep1993: folds
pilifish: folds
Tolins500: folds
Uncalled bet (124) returned to psitorch
psitorch collected 280 from pot
psitorch: doesn't show hand
*** SUMMARY ***
Total pot 280 | Rake 0
Seat 1: psitorch collected (280)
Seat 3: Cherep1993 (button) folded before Flop (didn't bet)
Seat 4: pilifish (small blind) folded before Flop
Seat 5: Tolins500 (big blind) folded before Flop
Seat 6: SuperQ22 folded before Flop (didn't bet)
Seat 7: marzocca696969 folded before Flop (didn't bet)
Seat 8: elketefuka folded before Flop (didn't bet)
Seat 9: TENSAI POKER folded before Flop (didn't bet)


*********** # 38 **************
PokerStars Hand #214024328281: Tournament #2896837020, $0.98+$0.12 USD Hold'em No Limit - Level V (40/80) - 2020/05/17 10:08:07 ET
Table '2896837020 67' 9-max Seat #4 is the button
Seat 1: psitorch (2518 in chips)
Seat 3: Cherep1993 (3993 in chips)
Seat 4: pilifish (2342 in chips)
Seat 5: Tolins500 (1568 in chips)
Seat 6: SuperQ22 (2166 in chips)
Seat 7: marzocca696969 (5691 in chips)
Seat 8: elketefuka (19954 in chips)
Seat 9: TENSAI POKER (5965 in chips)
psitorch: posts the ante 10
Cherep1993: posts the ante 10
pilifish: posts the ante 10
Tolins500: posts the ante 10
SuperQ22: posts the ante 10
marzocca696969: posts the ante 10
elketefuka: posts the ante 10
TENSAI POKER: posts the ante 10
Tolins500: posts small blind 40
SuperQ22: posts big blind 80
*** HOLE CARDS ***
Dealt to elketefuka [5h 8d]
marzocca696969: calls 80
elketefuka: folds
TENSAI POKER: folds
psitorch: raises 208 to 288
Cherep1993: raises 3695 to 3983 and is all-in
pilifish: folds
Tolins500: calls 1518 and is all-in
SuperQ22: folds
marzocca696969 has timed out
marzocca696969: folds
marzocca696969 is sitting out
psitorch: calls 2220 and is all-in
Uncalled bet (1475) returned to Cherep1993
*** FLOP *** [4s Ts Jd]
marzocca696969 has returned
*** TURN *** [4s Ts Jd] [9d]
*** RIVER *** [4s Ts Jd 9d] [6s]
*** SHOW DOWN ***
psitorch: shows [Ks Kh] (a pair of Kings)
Cherep1993: shows [Ah Ac] (a pair of Aces)
Cherep1993 collected 1900 from side pot
Tolins500: shows [6h 6c] (three of a kind, Sixes)
Tolins500 collected 4914 from main pot
psitorch finished the tournament in 3233rd place
*** SUMMARY ***
Total pot 6814 Main pot 4914. Side pot 1900. | Rake 0
Board [4s Ts Jd 9d 6s]
Seat 1: psitorch showed [Ks Kh] and lost with a pair of Kings
Seat 3: Cherep1993 showed [Ah Ac] and won (1900) with a pair of Aces
Seat 4: pilifish (button) folded before Flop (didn't bet)
Seat 5: Tolins500 (small blind) showed [6h 6c] and won (4914) with three of a kind, Sixes
Seat 6: SuperQ22 (big blind) folded before Flop
Seat 7: marzocca696969 folded before Flop
Seat 8: elketefuka folded before Flop (didn't bet)
Seat 9: TENSAI POKER folded before Flop (didn't bet)


*********** # 39 **************
PokerStars Hand #214024381601: Tournament #2896837020, $0.98+$0.12 USD Hold'em No Limit - Level V (40/80) - 2020/05/17 10:09:16 ET
Table '2896837020 67' 9-max Seat #5 is the button
Seat 2: Douskenov (3000 in chips)
Seat 3: Cherep1993 (3375 in chips)
Seat 4: pilifish (2332 in chips)
Seat 5: Tolins500 (4914 in chips)
Seat 6: SuperQ22 (2076 in chips)
Seat 7: marzocca696969 (5601 in chips)
Seat 8: elketefuka (19944 in chips)
Seat 9: TENSAI POKER (5955 in chips)
Douskenov: posts the ante 10
Cherep1993: posts the ante 10
pilifish: posts the ante 10
Tolins500: posts the ante 10
SuperQ22: posts the ante 10
marzocca696969: posts the ante 10
elketefuka: posts the ante 10
TENSAI POKER: posts the ante 10
SuperQ22: posts small blind 40
marzocca696969: posts big blind 80
*** HOLE CARDS ***
Dealt to elketefuka [8c Ah]
elketefuka: calls 80
TENSAI POKER: folds
Douskenov: calls 80
Cherep1993: raises 3285 to 3365 and is all-in
pilifish: folds
Tolins500: folds
SuperQ22: folds
marzocca696969: folds
elketefuka: folds
Douskenov: folds
Uncalled bet (3285) returned to Cherep1993
Cherep1993 collected 440 from pot
Cherep1993: doesn't show hand
*** SUMMARY ***
Total pot 440 | Rake 0
Seat 2: Douskenov folded before Flop
Seat 3: Cherep1993 collected (440)
Seat 4: pilifish folded before Flop (didn't bet)
Seat 5: Tolins500 (button) folded before Flop (didn't bet)
Seat 6: SuperQ22 (small blind) folded before Flop
Seat 7: marzocca696969 (big blind) folded before Flop
Seat 8: elketefuka folded before Flop
Seat 9: TENSAI POKER folded before Flop (didn't bet)


*********** # 40 **************
PokerStars Hand #214024440120: Tournament #2896837020, $0.98+$0.12 USD Hold'em No Limit - Level V (40/80) - 2020/05/17 10:10:32 ET
Table '2896837020 67' 9-max Seat #6 is the button
Seat 1: FerdiEki (3000 in chips)
Seat 2: Douskenov (2910 in chips)
Seat 3: Cherep1993 (3725 in chips)
Seat 4: pilifish (2322 in chips)
Seat 5: Tolins500 (4904 in chips)
Seat 6: SuperQ22 (2026 in chips)
Seat 7: marzocca696969 (5511 in chips)
Seat 8: elketefuka (19854 in chips)
Seat 9: TENSAI POKER (5945 in chips)
FerdiEki: posts the ante 10
Douskenov: posts the ante 10
Cherep1993: posts the ante 10
pilifish: posts the ante 10
Tolins500: posts the ante 10
SuperQ22: posts the ante 10
marzocca696969: posts the ante 10
elketefuka: posts the ante 10
TENSAI POKER: posts the ante 10
marzocca696969: posts small blind 40
elketefuka: posts big blind 80
*** HOLE CARDS ***
Dealt to elketefuka [Jc Qs]
TENSAI POKER: raises 120 to 200
FerdiEki: calls 200
Douskenov: folds
Cherep1993: folds
pilifish: folds
Tolins500: folds
SuperQ22: folds
marzocca696969 has timed out
marzocca696969: folds
marzocca696969 is sitting out
elketefuka: calls 120
*** FLOP *** [3h 7s 4d]
marzocca696969 has returned
elketefuka: checks
TENSAI POKER: bets 400
FerdiEki: raises 640 to 1040
elketefuka: folds
TENSAI POKER: raises 3794 to 4834
FerdiEki: calls 1750 and is all-in
Uncalled bet (2044) returned to TENSAI POKER
*** TURN *** [3h 7s 4d] [6d]
*** RIVER *** [3h 7s 4d 6d] [As]
*** SHOW DOWN ***
TENSAI POKER: shows [Kd Kc] (a pair of Kings)
FerdiEki: shows [6c 5h] (a straight, Three to Seven)
FerdiEki collected 6310 from pot
*** SUMMARY ***
Total pot 6310 | Rake 0
Board [3h 7s 4d 6d As]
Seat 1: FerdiEki showed [6c 5h] and won (6310) with a straight, Three to Seven
Seat 2: Douskenov folded before Flop (didn't bet)
Seat 3: Cherep1993 folded before Flop (didn't bet)
Seat 4: pilifish folded before Flop (didn't bet)
Seat 5: Tolins500 folded before Flop (didn't bet)
Seat 6: SuperQ22 (button) folded before Flop (didn't bet)
Seat 7: marzocca696969 (small blind) folded before Flop
Seat 8: elketefuka (big blind) folded on the Flop
Seat 9: TENSAI POKER showed [Kd Kc] and lost with a pair of Kings


*********** # 41 **************
PokerStars Hand #214024510861: Tournament #2896837020, $0.98+$0.12 USD Hold'em No Limit - Level VI (50/100) - 2020/05/17 10:12:02 ET
Table '2896837020 67' 9-max Seat #7 is the button
Seat 1: FerdiEki (6310 in chips)
Seat 2: Douskenov (2900 in chips)
Seat 3: Cherep1993 (3715 in chips)
Seat 4: pilifish (2312 in chips)
Seat 5: Tolins500 (4894 in chips)
Seat 6: SuperQ22 (2016 in chips)
Seat 7: marzocca696969 (5461 in chips)
Seat 8: elketefuka (19644 in chips)
Seat 9: TENSAI POKER (2945 in chips)
FerdiEki: posts the ante 12
Douskenov: posts the ante 12
Cherep1993: posts the ante 12
pilifish: posts the ante 12
Tolins500: posts the ante 12
SuperQ22: posts the ante 12
marzocca696969: posts the ante 12
elketefuka: posts the ante 12
TENSAI POKER: posts the ante 12
elketefuka: posts small blind 50
TENSAI POKER: posts big blind 100
*** HOLE CARDS ***
Dealt to elketefuka [2s Kc]
FerdiEki: calls 100
Douskenov: calls 100
Cherep1993: raises 100 to 200
pilifish: folds
Tolins500: folds
SuperQ22: folds
marzocca696969 has timed out
marzocca696969: folds
marzocca696969 is sitting out
elketefuka: folds
TENSAI POKER: folds
FerdiEki: calls 100
Douskenov: raises 858 to 1058
Cherep1993: calls 858
FerdiEki: calls 858
*** FLOP *** [Ah 7s Ac]
marzocca696969 has returned
FerdiEki: checks
Douskenov: bets 1830 and is all-in
Cherep1993: raises 815 to 2645 and is all-in
FerdiEki: folds
Uncalled bet (815) returned to Cherep1993
*** TURN *** [Ah 7s Ac] [3d]
*** RIVER *** [Ah 7s Ac 3d] [6d]
*** SHOW DOWN ***
Douskenov: shows [8c 8d] (two pair, Aces and Eights)
Cherep1993: shows [Kh Th] (a pair of Aces)
Douskenov collected 7092 from pot
*** SUMMARY ***
Total pot 7092 | Rake 0
Board [Ah 7s Ac 3d 6d]
Seat 1: FerdiEki folded on the Flop
Seat 2: Douskenov showed [8c 8d] and won (7092) with two pair, Aces and Eights
Seat 3: Cherep1993 showed [Kh Th] and lost with a pair of Aces
Seat 4: pilifish folded before Flop (didn't bet)
Seat 5: Tolins500 folded before Flop (didn't bet)
Seat 6: SuperQ22 folded before Flop (didn't bet)
Seat 7: marzocca696969 (button) folded before Flop (didn't bet)
Seat 8: elketefuka (small blind) folded before Flop
Seat 9: TENSAI POKER (big blind) folded before Flop


*********** # 42 **************
PokerStars Hand #214024571019: Tournament #2896837020, $0.98+$0.12 USD Hold'em No Limit - Level VI (50/100) - 2020/05/17 10:13:20 ET
Table '2896837020 67' 9-max Seat #8 is the button
Seat 1: FerdiEki (5240 in chips)
Seat 2: Douskenov (7092 in chips)
Seat 3: Cherep1993 (815 in chips)
Seat 4: pilifish (2300 in chips)
Seat 5: Tolins500 (4882 in chips)
Seat 6: SuperQ22 (2004 in chips)
Seat 7: marzocca696969 (5449 in chips)
Seat 8: elketefuka (19582 in chips)
Seat 9: TENSAI POKER (2833 in chips)
FerdiEki: posts the ante 12
Douskenov: posts the ante 12
Cherep1993: posts the ante 12
pilifish: posts the ante 12
Tolins500: posts the ante 12
SuperQ22: posts the ante 12
marzocca696969: posts the ante 12
elketefuka: posts the ante 12
TENSAI POKER: posts the ante 12
TENSAI POKER: posts small blind 50
FerdiEki: posts big blind 100
*** HOLE CARDS ***
Dealt to elketefuka [As Qc]
Douskenov: folds
Cherep1993: raises 703 to 803 and is all-in
pilifish: folds
Tolins500: folds
SuperQ22: folds
marzocca696969: calls 803
elketefuka: calls 803
TENSAI POKER: folds
FerdiEki: calls 703
*** FLOP *** [Ac 7h 5c]
FerdiEki: checks
marzocca696969 has timed out
marzocca696969: checks
elketefuka: bets 2100
FerdiEki: folds
marzocca696969: raises 2534 to 4634 and is all-in
elketefuka: calls 2534
*** TURN *** [Ac 7h 5c] [7s]
*** RIVER *** [Ac 7h 5c 7s] [Js]
*** SHOW DOWN ***
marzocca696969: shows [Ad 8d] (two pair, Aces and Sevens)
elketefuka: shows [As Qc] (two pair, Aces and Sevens - Queen kicker)
elketefuka collected 9268 from side pot
Cherep1993: shows [3h 7d] (three of a kind, Sevens)
Cherep1993 collected 3370 from main pot
marzocca696969 finished the tournament in 3085th place
*** SUMMARY ***
Total pot 12638 Main pot 3370. Side pot 9268. | Rake 0
Board [Ac 7h 5c 7s Js]
Seat 1: FerdiEki (big blind) folded on the Flop
Seat 2: Douskenov folded before Flop (didn't bet)
Seat 3: Cherep1993 showed [3h 7d] and won (3370) with three of a kind, Sevens
Seat 4: pilifish folded before Flop (didn't bet)
Seat 5: Tolins500 folded before Flop (didn't bet)
Seat 6: SuperQ22 folded before Flop (didn't bet)
Seat 7: marzocca696969 showed [Ad 8d] and lost with two pair, Aces and Sevens
Seat 8: elketefuka (button) showed [As Qc] and won (9268) with two pair, Aces and Sevens
Seat 9: TENSAI POKER (small blind) folded before Flop


*********** # 43 **************
PokerStars Hand #214024630466: Tournament #2896837020, $0.98+$0.12 USD Hold'em No Limit - Level VI (50/100) - 2020/05/17 10:14:37 ET
Table '2896837020 67' 9-max Seat #9 is the button
Seat 1: FerdiEki (4425 in chips)
Seat 2: Douskenov (7080 in chips)
Seat 3: Cherep1993 (3370 in chips)
Seat 4: pilifish (2288 in chips)
Seat 5: Tolins500 (4870 in chips)
Seat 6: SuperQ22 (1992 in chips)
Seat 8: elketefuka (23401 in chips)
Seat 9: TENSAI POKER (2771 in chips)
FerdiEki: posts the ante 12
Douskenov: posts the ante 12
Cherep1993: posts the ante 12
pilifish: posts the ante 12
Tolins500: posts the ante 12
SuperQ22: posts the ante 12
elketefuka: posts the ante 12
TENSAI POKER: posts the ante 12
FerdiEki: posts small blind 50
Douskenov: posts big blind 100
*** HOLE CARDS ***
Dealt to elketefuka [5h 7h]
Cherep1993: folds
pilifish: folds
Tolins500: raises 100 to 200
SuperQ22: folds
elketefuka: calls 200
TENSAI POKER: calls 200
FerdiEki: calls 150
Douskenov: calls 100
*** FLOP *** [Jc Ks 4d]
FerdiEki: checks
Douskenov: bets 1100
Tolins500: calls 1100
elketefuka: folds
TENSAI POKER: folds
FerdiEki: folds
*** TURN *** [Jc Ks 4d] [3h]
Douskenov: bets 3300
Tolins500: folds
Uncalled bet (3300) returned to Douskenov
Douskenov collected 3296 from pot
Douskenov: doesn't show hand
*** SUMMARY ***
Total pot 3296 | Rake 0
Board [Jc Ks 4d 3h]
Seat 1: FerdiEki (small blind) folded on the Flop
Seat 2: Douskenov (big blind) collected (3296)
Seat 3: Cherep1993 folded before Flop (didn't bet)
Seat 4: pilifish folded before Flop (didn't bet)
Seat 5: Tolins500 folded on the Turn
Seat 6: SuperQ22 folded before Flop (didn't bet)
Seat 8: elketefuka folded on the Flop
Seat 9: TENSAI POKER (button) folded on the Flop


*********** # 44 **************
PokerStars Hand #214024699175: Tournament #2896837020, $0.98+$0.12 USD Hold'em No Limit - Level VI (50/100) - 2020/05/17 10:16:04 ET
Table '2896837020 67' 9-max Seat #1 is the button
Seat 1: FerdiEki (4213 in chips)
Seat 2: Douskenov (9064 in chips)
Seat 3: Cherep1993 (3358 in chips)
Seat 4: pilifish (2276 in chips)
Seat 5: Tolins500 (3558 in chips)
Seat 6: SuperQ22 (1980 in chips)
Seat 7: NeCTar222 (15099 in chips)
Seat 8: elketefuka (23189 in chips)
Seat 9: TENSAI POKER (2559 in chips)
FerdiEki: posts the ante 12
Douskenov: posts the ante 12
Cherep1993: posts the ante 12
pilifish: posts the ante 12
Tolins500: posts the ante 12
SuperQ22: posts the ante 12
NeCTar222: posts the ante 12
elketefuka: posts the ante 12
TENSAI POKER: posts the ante 12
Douskenov: posts small blind 50
Cherep1993: posts big blind 100
*** HOLE CARDS ***
Dealt to elketefuka [6h 8h]
pilifish: folds
Tolins500: folds
SuperQ22: raises 100 to 200
NeCTar222: calls 200
elketefuka: calls 200
TENSAI POKER: folds
FerdiEki: calls 200
Douskenov: folds
Cherep1993: folds
*** FLOP *** [5s 4d Ts]
SuperQ22: checks
NeCTar222: checks
elketefuka: bets 529
FerdiEki: calls 529
SuperQ22: raises 1239 to 1768 and is all-in
NeCTar222: folds
elketefuka: folds
FerdiEki: folds
Uncalled bet (1239) returned to SuperQ22
SuperQ22 collected 2645 from pot
SuperQ22: doesn't show hand
*** SUMMARY ***
Total pot 2645 | Rake 0
Board [5s 4d Ts]
Seat 1: FerdiEki (button) folded on the Flop
Seat 2: Douskenov (small blind) folded before Flop
Seat 3: Cherep1993 (big blind) folded before Flop
Seat 4: pilifish folded before Flop (didn't bet)
Seat 5: Tolins500 folded before Flop (didn't bet)
Seat 6: SuperQ22 collected (2645)
Seat 7: NeCTar222 folded on the Flop
Seat 8: elketefuka folded on the Flop
Seat 9: TENSAI POKER folded before Flop (didn't bet)


*********** # 45 **************
PokerStars Hand #214024732293: Tournament #2896837020, $0.98+$0.12 USD Hold'em No Limit - Level VI (50/100) - 2020/05/17 10:16:46 ET
Table '2896837020 67' 9-max Seat #2 is the button
Seat 1: FerdiEki (3472 in chips)
Seat 2: Douskenov (9002 in chips)
Seat 3: Cherep1993 (3246 in chips)
Seat 4: pilifish (2264 in chips)
Seat 5: Tolins500 (3546 in chips)
Seat 6: SuperQ22 (3884 in chips)
Seat 7: NeCTar222 (14887 in chips)
Seat 8: elketefuka (22448 in chips)
Seat 9: TENSAI POKER (2547 in chips)
FerdiEki: posts the ante 12
Douskenov: posts the ante 12
Cherep1993: posts the ante 12
pilifish: posts the ante 12
Tolins500: posts the ante 12
SuperQ22: posts the ante 12
NeCTar222: posts the ante 12
elketefuka: posts the ante 12
TENSAI POKER: posts the ante 12
Cherep1993: posts small blind 50
pilifish: posts big blind 100
*** HOLE CARDS ***
Dealt to elketefuka [Qh 6c]
Tolins500: raises 200 to 300
SuperQ22: calls 300
NeCTar222: folds
elketefuka: folds
TENSAI POKER: folds
FerdiEki: folds
Douskenov: folds
Cherep1993: raises 2934 to 3234 and is all-in
pilifish: folds
Tolins500: raises 300 to 3534 and is all-in
SuperQ22: calls 3234
*** FLOP *** [9d 5s Jh]
*** TURN *** [9d 5s Jh] [Qc]
*** RIVER *** [9d 5s Jh Qc] [7s]
*** SHOW DOWN ***
Tolins500: shows [Kd Ad] (high card Ace)
SuperQ22: shows [Ac Ah] (a pair of Aces)
SuperQ22 collected 600 from side pot
Cherep1993: shows [7d 7c] (three of a kind, Sevens)
Cherep1993 collected 9910 from main pot
Tolins500 finished the tournament in 2976th place
*** SUMMARY ***
Total pot 10510 Main pot 9910. Side pot 600. | Rake 0
Board [9d 5s Jh Qc 7s]
Seat 1: FerdiEki folded before Flop (didn't bet)
Seat 2: Douskenov (button) folded before Flop (didn't bet)
Seat 3: Cherep1993 (small blind) showed [7d 7c] and won (9910) with three of a kind, Sevens
Seat 4: pilifish (big blind) folded before Flop
Seat 5: Tolins500 showed [Kd Ad] and lost with high card Ace
Seat 6: SuperQ22 showed [Ac Ah] and won (600) with a pair of Aces
Seat 7: NeCTar222 folded before Flop (didn't bet)
Seat 8: elketefuka folded before Flop (didn't bet)
Seat 9: TENSAI POKER folded before Flop (didn't bet)


*********** # 46 **************
PokerStars Hand #214024768247: Tournament #2896837020, $0.98+$0.12 USD Hold'em No Limit - Level VI (50/100) - 2020/05/17 10:17:31 ET
Table '2896837020 67' 9-max Seat #3 is the button
Seat 1: FerdiEki (3460 in chips)
Seat 2: Douskenov (8990 in chips)
Seat 3: Cherep1993 (9910 in chips)
Seat 4: pilifish (2152 in chips)
Seat 6: SuperQ22 (938 in chips)
Seat 7: NeCTar222 (14875 in chips)
Seat 8: elketefuka (22436 in chips)
Seat 9: TENSAI POKER (2535 in chips)
FerdiEki: posts the ante 12
Douskenov: posts the ante 12
Cherep1993: posts the ante 12
pilifish: posts the ante 12
SuperQ22: posts the ante 12
NeCTar222: posts the ante 12
elketefuka: posts the ante 12
TENSAI POKER: posts the ante 12
pilifish: posts small blind 50
SuperQ22: posts big blind 100
*** HOLE CARDS ***
Dealt to elketefuka [7h 9s]
NeCTar222: calls 100
elketefuka: folds
TENSAI POKER: folds
FerdiEki: raises 3348 to 3448 and is all-in
Douskenov: folds
Cherep1993: raises 6450 to 9898 and is all-in
pilifish: folds
SuperQ22: folds
NeCTar222: folds
Uncalled bet (6450) returned to Cherep1993
*** FLOP *** [8s Js Kd]
*** TURN *** [8s Js Kd] [Qs]
*** RIVER *** [8s Js Kd Qs] [Jh]
*** SHOW DOWN ***
FerdiEki: shows [6d 6h] (two pair, Jacks and Sixes)
Cherep1993: shows [Kc Kh] (a full house, Kings full of Jacks)
Cherep1993 collected 7242 from pot
FerdiEki finished the tournament in 2962nd place
*** SUMMARY ***
Total pot 7242 | Rake 0
Board [8s Js Kd Qs Jh]
Seat 1: FerdiEki showed [6d 6h] and lost with two pair, Jacks and Sixes
Seat 2: Douskenov folded before Flop (didn't bet)
Seat 3: Cherep1993 (button) showed [Kc Kh] and won (7242) with a full house, Kings full of Jacks
Seat 4: pilifish (small blind) folded before Flop
Seat 6: SuperQ22 (big blind) folded before Flop
Seat 7: NeCTar222 folded before Flop
Seat 8: elketefuka folded before Flop (didn't bet)
Seat 9: TENSAI POKER folded before Flop (didn't bet)


*********** # 47 **************
PokerStars Hand #214024794159: Tournament #2896837020, $0.98+$0.12 USD Hold'em No Limit - Level VI (50/100) - 2020/05/17 10:18:05 ET
Table '2896837020 67' 9-max Seat #4 is the button
Seat 2: Douskenov (8978 in chips)
Seat 3: Cherep1993 (13692 in chips)
Seat 4: pilifish (2090 in chips)
Seat 5: cedricdb95 (6235 in chips) out of hand (moved from another table into small blind)
Seat 6: SuperQ22 (826 in chips)
Seat 7: NeCTar222 (14763 in chips)
Seat 8: elketefuka (22424 in chips)
Seat 9: TENSAI POKER (2523 in chips)
cedricdb95 will be allowed to play after the button
Douskenov: posts the ante 12
Cherep1993: posts the ante 12
pilifish: posts the ante 12
SuperQ22: posts the ante 12
NeCTar222: posts the ante 12
elketefuka: posts the ante 12
TENSAI POKER: posts the ante 12
SuperQ22: posts small blind 50
NeCTar222: posts big blind 100
*** HOLE CARDS ***
Dealt to elketefuka [Jd 9s]
elketefuka: folds
TENSAI POKER: folds
Douskenov: folds
Cherep1993: folds
pilifish: folds
SuperQ22: raises 714 to 814 and is all-in
NeCTar222: calls 714
*** FLOP *** [9c 7h Qh]
*** TURN *** [9c 7h Qh] [Qc]
*** RIVER *** [9c 7h Qh Qc] [5c]
*** SHOW DOWN ***
SuperQ22: shows [8c Ts] (a pair of Queens)
NeCTar222: shows [Kd Ah] (a pair of Queens - Ace kicker)
NeCTar222 collected 1712 from pot
SuperQ22 finished the tournament in 2941st place
*** SUMMARY ***
Total pot 1712 | Rake 0
Board [9c 7h Qh Qc 5c]
Seat 2: Douskenov folded before Flop (didn't bet)
Seat 3: Cherep1993 folded before Flop (didn't bet)
Seat 4: pilifish (button) folded before Flop (didn't bet)
Seat 6: SuperQ22 (small blind) showed [8c Ts] and lost with a pair of Queens
Seat 7: NeCTar222 (big blind) showed [Kd Ah] and won (1712) with a pair of Queens
Seat 8: elketefuka folded before Flop (didn't bet)
Seat 9: TENSAI POKER folded before Flop (didn't bet)


*********** # 48 **************
PokerStars Hand #214024814978: Tournament #2896837020, $0.98+$0.12 USD Hold'em No Limit - Level VI (50/100) - 2020/05/17 10:18:31 ET
Table '2896837020 67' 9-max Seat #7 is the button
Seat 1: borohul8998 (2601 in chips)
Seat 2: Douskenov (8966 in chips)
Seat 3: Cherep1993 (13680 in chips)
Seat 4: pilifish (2078 in chips)
Seat 5: cedricdb95 (6235 in chips)
Seat 7: NeCTar222 (15649 in chips)
Seat 8: elketefuka (22412 in chips)
Seat 9: TENSAI POKER (2511 in chips)
borohul8998: posts the ante 12
Douskenov: posts the ante 12
Cherep1993: posts the ante 12
pilifish: posts the ante 12
cedricdb95: posts the ante 12
NeCTar222: posts the ante 12
elketefuka: posts the ante 12
TENSAI POKER: posts the ante 12
elketefuka: posts small blind 50
TENSAI POKER: posts big blind 100
*** HOLE CARDS ***
Dealt to elketefuka [Ks 5d]
borohul8998: folds
Douskenov: folds
Cherep1993: calls 100
pilifish: folds
cedricdb95: folds
NeCTar222: folds
elketefuka: calls 50
TENSAI POKER: checks
*** FLOP *** [8c Kh Qs]
elketefuka: checks
TENSAI POKER: checks
Cherep1993: bets 100
elketefuka: raises 250 to 350
TENSAI POKER: raises 861 to 1211
Cherep1993: folds
elketefuka: folds
Uncalled bet (861) returned to TENSAI POKER
TENSAI POKER collected 1196 from pot
TENSAI POKER: doesn't show hand
*** SUMMARY ***
Total pot 1196 | Rake 0
Board [8c Kh Qs]
Seat 1: borohul8998 folded before Flop (didn't bet)
Seat 2: Douskenov folded before Flop (didn't bet)
Seat 3: Cherep1993 folded on the Flop
Seat 4: pilifish folded before Flop (didn't bet)
Seat 5: cedricdb95 folded before Flop (didn't bet)
Seat 7: NeCTar222 (button) folded before Flop (didn't bet)
Seat 8: elketefuka (small blind) folded on the Flop
Seat 9: TENSAI POKER (big blind) collected (1196)


*********** # 49 **************
PokerStars Hand #214024877722: Tournament #2896837020, $0.98+$0.12 USD Hold'em No Limit - Level VI (50/100) - 2020/05/17 10:19:47 ET
Table '2896837020 67' 9-max Seat #8 is the button
Seat 1: borohul8998 (2589 in chips)
Seat 2: Douskenov (8954 in chips)
Seat 3: Cherep1993 (13468 in chips)
Seat 4: pilifish (2066 in chips)
Seat 5: cedricdb95 (6223 in chips)
Seat 6: Raddow (3000 in chips)
Seat 7: NeCTar222 (15637 in chips)
Seat 8: elketefuka (21950 in chips)
Seat 9: TENSAI POKER (3245 in chips)
borohul8998: posts the ante 12
Douskenov: posts the ante 12
Cherep1993: posts the ante 12
pilifish: posts the ante 12
cedricdb95: posts the ante 12
Raddow: posts the ante 12
NeCTar222: posts the ante 12
elketefuka: posts the ante 12
TENSAI POKER: posts the ante 12
TENSAI POKER: posts small blind 50
borohul8998: posts big blind 100
*** HOLE CARDS ***
Dealt to elketefuka [Ks 8c]
Douskenov: folds
Cherep1993: calls 100
pilifish: folds
cedricdb95: calls 100
Raddow: calls 100
NeCTar222: calls 100
elketefuka: calls 100
TENSAI POKER: folds
borohul8998: checks
*** FLOP *** [Jc 4h 2d]
borohul8998: checks
Cherep1993: checks
cedricdb95: bets 400
Raddow: folds
NeCTar222: calls 400
elketefuka has timed out
elketefuka: folds
elketefuka is sitting out
borohul8998: folds
Cherep1993: folds
*** TURN *** [Jc 4h 2d] [9s]
cedricdb95: bets 1000
NeCTar222: calls 1000
*** RIVER *** [Jc 4h 2d 9s] [4c]
cedricdb95: bets 800
NeCTar222: calls 800
*** SHOW DOWN ***
cedricdb95: shows [Ah Kh] (a pair of Fours)
NeCTar222: shows [3d Jd] (two pair, Jacks and Fours)
NeCTar222 collected 5158 from pot
*** SUMMARY ***
Total pot 5158 | Rake 0
Board [Jc 4h 2d 9s 4c]
Seat 1: borohul8998 (big blind) folded on the Flop
Seat 2: Douskenov folded before Flop (didn't bet)
Seat 3: Cherep1993 folded on the Flop
Seat 4: pilifish folded before Flop (didn't bet)
Seat 5: cedricdb95 showed [Ah Kh] and lost with a pair of Fours
Seat 6: Raddow folded on the Flop
Seat 7: NeCTar222 showed [3d Jd] and won (5158) with two pair, Jacks and Fours
Seat 8: elketefuka (button) folded on the Flop
Seat 9: TENSAI POKER (small blind) folded before Flop


*********** # 50 **************
PokerStars Hand #214024989994: Tournament #2896837020, $0.98+$0.12 USD Hold'em No Limit - Level VII (60/120) - 2020/05/17 10:22:08 ET
Table '2896837020 67' 9-max Seat #9 is the button
Seat 1: borohul8998 (2477 in chips)
Seat 2: Douskenov (8942 in chips)
Seat 3: Cherep1993 (13356 in chips)
Seat 4: pilifish (2054 in chips)
Seat 5: cedricdb95 (3911 in chips)
Seat 6: Raddow (2888 in chips)
Seat 7: NeCTar222 (18483 in chips)
Seat 8: elketefuka (21838 in chips) is sitting out
Seat 9: TENSAI POKER (3183 in chips)
borohul8998: posts the ante 15
Douskenov: posts the ante 15
Cherep1993: posts the ante 15
pilifish: posts the ante 15
cedricdb95: posts the ante 15
Raddow: posts the ante 15
NeCTar222: posts the ante 15
elketefuka: posts the ante 15
TENSAI POKER: posts the ante 15
borohul8998: posts small blind 60
Douskenov: posts big blind 120
*** HOLE CARDS ***
Dealt to elketefuka [Qh 2c]
Cherep1993: folds
pilifish: folds
cedricdb95: folds
Raddow: folds
NeCTar222: folds
elketefuka: folds
TENSAI POKER: raises 180 to 300
borohul8998: calls 240
Douskenov: folds
*** FLOP *** [As Ah 9s]
borohul8998: checks
elketefuka is disconnected
TENSAI POKER: bets 308
borohul8998: folds
Uncalled bet (308) returned to TENSAI POKER
TENSAI POKER collected 855 from pot
TENSAI POKER: doesn't show hand
*** SUMMARY ***
Total pot 855 | Rake 0
Board [As Ah 9s]
Seat 1: borohul8998 (small blind) folded on the Flop
Seat 2: Douskenov (big blind) folded before Flop
Seat 3: Cherep1993 folded before Flop (didn't bet)
Seat 4: pilifish folded before Flop (didn't bet)
Seat 5: cedricdb95 folded before Flop (didn't bet)
Seat 6: Raddow folded before Flop (didn't bet)
Seat 7: NeCTar222 folded before Flop (didn't bet)
Seat 8: elketefuka folded before Flop (didn't bet)
Seat 9: TENSAI POKER (button) collected (855)


*********** # 51 **************
PokerStars Hand #214025026770: Tournament #2896837020, $0.98+$0.12 USD Hold'em No Limit - Level VII (60/120) - 2020/05/17 10:22:54 ET
Table '2896837020 67' 9-max Seat #1 is the button
Seat 1: borohul8998 (2162 in chips)
Seat 2: Douskenov (8807 in chips)
Seat 3: Cherep1993 (13341 in chips)
Seat 4: pilifish (2039 in chips)
Seat 5: cedricdb95 (3896 in chips)
Seat 6: Raddow (2873 in chips)
Seat 7: NeCTar222 (18468 in chips)
Seat 8: elketefuka (21823 in chips) is sitting out
Seat 9: TENSAI POKER (3723 in chips)
borohul8998: posts the ante 15
Douskenov: posts the ante 15
Cherep1993: posts the ante 15
pilifish: posts the ante 15
cedricdb95: posts the ante 15
Raddow: posts the ante 15
NeCTar222: posts the ante 15
elketefuka: posts the ante 15
TENSAI POKER: posts the ante 15
Douskenov: posts small blind 60
Cherep1993: posts big blind 120
*** HOLE CARDS ***
Dealt to elketefuka [Jc 4h]
pilifish: folds
cedricdb95: folds
Raddow: folds
NeCTar222: folds
elketefuka: folds
TENSAI POKER: folds
borohul8998: calls 120
Douskenov: calls 60
Cherep1993: checks
*** FLOP *** [3d Jd 5s]
Douskenov: bets 480
Cherep1993: folds
borohul8998: calls 480
*** TURN *** [3d Jd 5s] [Kh]
Douskenov: bets 600
borohul8998: folds
Uncalled bet (600) returned to Douskenov
Douskenov collected 1455 from pot
Douskenov: doesn't show hand
*** SUMMARY ***
Total pot 1455 | Rake 0
Board [3d Jd 5s Kh]
Seat 1: borohul8998 (button) folded on the Turn
Seat 2: Douskenov (small blind) collected (1455)
Seat 3: Cherep1993 (big blind) folded on the Flop
Seat 4: pilifish folded before Flop (didn't bet)
Seat 5: cedricdb95 folded before Flop (didn't bet)
Seat 6: Raddow folded before Flop (didn't bet)
Seat 7: NeCTar222 folded before Flop (didn't bet)
Seat 8: elketefuka folded before Flop (didn't bet)
Seat 9: TENSAI POKER folded before Flop (didn't bet)


*********** # 52 **************
PokerStars Hand #214025068575: Tournament #2896837020, $0.98+$0.12 USD Hold'em No Limit - Level VII (60/120) - 2020/05/17 10:23:47 ET
Table '2896837020 67' 9-max Seat #2 is the button
Seat 1: borohul8998 (1547 in chips)
Seat 2: Douskenov (9647 in chips)
Seat 3: Cherep1993 (13206 in chips)
Seat 4: pilifish (2024 in chips)
Seat 5: cedricdb95 (3881 in chips)
Seat 6: Raddow (2858 in chips)
Seat 7: NeCTar222 (18453 in chips)
Seat 8: elketefuka (21808 in chips) is sitting out
Seat 9: TENSAI POKER (3708 in chips)
borohul8998: posts the ante 15
Douskenov: posts the ante 15
Cherep1993: posts the ante 15
pilifish: posts the ante 15
cedricdb95: posts the ante 15
Raddow: posts the ante 15
NeCTar222: posts the ante 15
elketefuka: posts the ante 15
TENSAI POKER: posts the ante 15
Cherep1993: posts small blind 60
pilifish: posts big blind 120
*** HOLE CARDS ***
Dealt to elketefuka [2h Qc]
cedricdb95: calls 120
Raddow: folds
elketefuka has returned
NeCTar222: folds
elketefuka: folds
TENSAI POKER: folds
borohul8998: folds
Douskenov: calls 120
Cherep1993: folds
pilifish: checks
*** FLOP *** [Qd 5c Ts]
pilifish: checks
cedricdb95: bets 120
Douskenov: raises 360 to 480
pilifish: calls 480
cedricdb95: raises 3266 to 3746 and is all-in
Douskenov: folds
pilifish: calls 1409 and is all-in
Uncalled bet (1857) returned to cedricdb95
*** TURN *** [Qd 5c Ts] [9s]
*** RIVER *** [Qd 5c Ts 9s] [Jc]
*** SHOW DOWN ***
pilifish: shows [5d 5s] (three of a kind, Fives)
cedricdb95: shows [9h 8d] (a straight, Eight to Queen)
cedricdb95 collected 4813 from pot
pilifish finished the tournament in 2725th place
*** SUMMARY ***
Total pot 4813 | Rake 0
Board [Qd 5c Ts 9s Jc]
Seat 1: borohul8998 folded before Flop (didn't bet)
Seat 2: Douskenov (button) folded on the Flop
Seat 3: Cherep1993 (small blind) folded before Flop
Seat 4: pilifish (big blind) showed [5d 5s] and lost with three of a kind, Fives
Seat 5: cedricdb95 showed [9h 8d] and won (4813) with a straight, Eight to Queen
Seat 6: Raddow folded before Flop (didn't bet)
Seat 7: NeCTar222 folded before Flop (didn't bet)
Seat 8: elketefuka folded before Flop (didn't bet)
Seat 9: TENSAI POKER folded before Flop (didn't bet)


*********** # 53 **************
PokerStars Hand #214025133135: Tournament #2896837020, $0.98+$0.12 USD Hold'em No Limit - Level VII (60/120) - 2020/05/17 10:25:08 ET
Table '2896837020 67' 9-max Seat #3 is the button
Seat 1: borohul8998 (1532 in chips)
Seat 2: Douskenov (9032 in chips)
Seat 3: Cherep1993 (13131 in chips)
Seat 5: cedricdb95 (6670 in chips)
Seat 6: Raddow (2843 in chips)
Seat 7: NeCTar222 (18438 in chips)
Seat 8: elketefuka (21793 in chips)
Seat 9: TENSAI POKER (3693 in chips)
borohul8998: posts the ante 15
Douskenov: posts the ante 15
Cherep1993: posts the ante 15
cedricdb95: posts the ante 15
Raddow: posts the ante 15
NeCTar222: posts the ante 15
elketefuka: posts the ante 15
TENSAI POKER: posts the ante 15
cedricdb95: posts small blind 60
Raddow: posts big blind 120
*** HOLE CARDS ***
Dealt to elketefuka [3h Ah]
NeCTar222: folds
elketefuka: calls 120
TENSAI POKER: folds
borohul8998: calls 120
Douskenov: folds
Cherep1993: folds
cedricdb95: folds
Raddow: raises 2708 to 2828 and is all-in
elketefuka: folds
borohul8998: folds
Uncalled bet (2708) returned to Raddow
Raddow collected 540 from pot
Raddow: doesn't show hand
*** SUMMARY ***
Total pot 540 | Rake 0
Seat 1: borohul8998 folded before Flop
Seat 2: Douskenov folded before Flop (didn't bet)
Seat 3: Cherep1993 (button) folded before Flop (didn't bet)
Seat 5: cedricdb95 (small blind) folded before Flop
Seat 6: Raddow (big blind) collected (540)
Seat 7: NeCTar222 folded before Flop (didn't bet)
Seat 8: elketefuka folded before Flop
Seat 9: TENSAI POKER folded before Flop (didn't bet)


*********** # 54 **************
PokerStars Hand #214025177885: Tournament #2896837020, $0.98+$0.12 USD Hold'em No Limit - Level VII (60/120) - 2020/05/17 10:26:04 ET
Table '2896837020 67' 9-max Seat #5 is the button
Seat 1: borohul8998 (1397 in chips)
Seat 2: Douskenov (9017 in chips)
Seat 3: Cherep1993 (13116 in chips)
Seat 4: DKerridge14 (3000 in chips)
Seat 5: cedricdb95 (6595 in chips)
Seat 6: Raddow (3248 in chips)
Seat 7: NeCTar222 (18423 in chips)
Seat 8: elketefuka (21658 in chips)
Seat 9: TENSAI POKER (3678 in chips)
borohul8998: posts the ante 15
Douskenov: posts the ante 15
Cherep1993: posts the ante 15
DKerridge14: posts the ante 15
cedricdb95: posts the ante 15
Raddow: posts the ante 15
NeCTar222: posts the ante 15
elketefuka: posts the ante 15
TENSAI POKER: posts the ante 15
Raddow: posts small blind 60
NeCTar222: posts big blind 120
*** HOLE CARDS ***
Dealt to elketefuka [Ts Th]
elketefuka: raises 240 to 360
TENSAI POKER: folds
borohul8998: folds
Douskenov: folds
Cherep1993: folds
DKerridge14: folds
cedricdb95 has timed out
cedricdb95: folds
cedricdb95 is sitting out
Raddow: raises 2873 to 3233 and is all-in
NeCTar222: folds
elketefuka: calls 2873
*** FLOP *** [9h 8s As]
*** TURN *** [9h 8s As] [3s]
*** RIVER *** [9h 8s As 3s] [9d]
*** SHOW DOWN ***
Raddow: shows [Ks Ac] (two pair, Aces and Nines)
elketefuka: shows [Ts Th] (two pair, Tens and Nines)
Raddow collected 6721 from pot
*** SUMMARY ***
Total pot 6721 | Rake 0
Board [9h 8s As 3s 9d]
Seat 1: borohul8998 folded before Flop (didn't bet)
Seat 2: Douskenov folded before Flop (didn't bet)
Seat 3: Cherep1993 folded before Flop (didn't bet)
Seat 4: DKerridge14 folded before Flop (didn't bet)
Seat 5: cedricdb95 (button) folded before Flop (didn't bet)
Seat 6: Raddow (small blind) showed [Ks Ac] and won (6721) with two pair, Aces and Nines
Seat 7: NeCTar222 (big blind) folded before Flop
Seat 8: elketefuka showed [Ts Th] and lost with two pair, Tens and Nines
Seat 9: TENSAI POKER folded before Flop (didn't bet)


*********** # 55 **************
PokerStars Hand #214025243162: Tournament #2896837020, $0.98+$0.12 USD Hold'em No Limit - Level VII (60/120) - 2020/05/17 10:27:17 ET
Table '2896837020 67' 9-max Seat #6 is the button
Seat 1: borohul8998 (1382 in chips)
Seat 2: Douskenov (9002 in chips)
Seat 3: Cherep1993 (13101 in chips)
Seat 4: DKerridge14 (2985 in chips)
Seat 5: cedricdb95 (6580 in chips) is sitting out
Seat 6: Raddow (6721 in chips)
Seat 7: NeCTar222 (18288 in chips)
Seat 8: elketefuka (18410 in chips)
Seat 9: TENSAI POKER (3663 in chips)
borohul8998: posts the ante 15
Douskenov: posts the ante 15
Cherep1993: posts the ante 15
DKerridge14: posts the ante 15
cedricdb95: posts the ante 15
Raddow: posts the ante 15
NeCTar222: posts the ante 15
elketefuka: posts the ante 15
TENSAI POKER: posts the ante 15
NeCTar222: posts small blind 60
elketefuka: posts big blind 120
*** HOLE CARDS ***
Dealt to elketefuka [Qd 2h]
TENSAI POKER: folds
borohul8998: folds
Douskenov: folds
Cherep1993: folds
DKerridge14: folds
cedricdb95: folds
Raddow: folds
NeCTar222: calls 60
elketefuka: checks
*** FLOP *** [7c Js Jh]
NeCTar222: checks
elketefuka: bets 188
NeCTar222: calls 188
*** TURN *** [7c Js Jh] [2s]
NeCTar222: checks
cedricdb95 has returned
elketefuka: checks
*** RIVER *** [7c Js Jh 2s] [8s]
NeCTar222: checks
elketefuka: bets 376
NeCTar222: calls 376
*** SHOW DOWN ***
elketefuka: shows [Qd 2h] (two pair, Jacks and Deuces)
NeCTar222: shows [Ts 9c] (a straight, Seven to Jack)
NeCTar222 collected 1503 from pot
*** SUMMARY ***
Total pot 1503 | Rake 0
Board [7c Js Jh 2s 8s]
Seat 1: borohul8998 folded before Flop (didn't bet)
Seat 2: Douskenov folded before Flop (didn't bet)
Seat 3: Cherep1993 folded before Flop (didn't bet)
Seat 4: DKerridge14 folded before Flop (didn't bet)
Seat 5: cedricdb95 folded before Flop (didn't bet)
Seat 6: Raddow (button) folded before Flop (didn't bet)
Seat 7: NeCTar222 (small blind) showed [Ts 9c] and won (1503) with a straight, Seven to Jack
Seat 8: elketefuka (big blind) showed [Qd 2h] and lost with two pair, Jacks and Deuces
Seat 9: TENSAI POKER folded before Flop (didn't bet)


*********** # 56 **************
PokerStars Hand #214025269520: Tournament #2896837020, $0.98+$0.12 USD Hold'em No Limit - Level VII (60/120) - 2020/05/17 10:27:50 ET
Table '2896837020 67' 9-max Seat #7 is the button
Seat 1: borohul8998 (1367 in chips)
Seat 2: Douskenov (8987 in chips)
Seat 3: Cherep1993 (13086 in chips)
Seat 4: DKerridge14 (2970 in chips)
Seat 5: cedricdb95 (6565 in chips)
Seat 6: Raddow (6706 in chips)
Seat 7: NeCTar222 (19092 in chips)
Seat 8: elketefuka (17711 in chips)
Seat 9: TENSAI POKER (3648 in chips)
borohul8998: posts the ante 15
Douskenov: posts the ante 15
Cherep1993: posts the ante 15
DKerridge14: posts the ante 15
cedricdb95: posts the ante 15
Raddow: posts the ante 15
NeCTar222: posts the ante 15
elketefuka: posts the ante 15
TENSAI POKER: posts the ante 15
elketefuka: posts small blind 60
TENSAI POKER: posts big blind 120
*** HOLE CARDS ***
Dealt to elketefuka [9d Kd]
borohul8998: folds
Douskenov: raises 435 to 555
Cherep1993: calls 555
DKerridge14: folds
cedricdb95: folds
Raddow: folds
NeCTar222: folds
elketefuka: folds
TENSAI POKER: calls 435
*** FLOP *** [7h 6c 2s]
TENSAI POKER: checks
Douskenov: bets 1800
Cherep1993: raises 1800 to 3600
TENSAI POKER: folds
Douskenov: raises 4817 to 8417 and is all-in
Cherep1993: calls 4817
*** TURN *** [7h 6c 2s] [Ts]
*** RIVER *** [7h 6c 2s Ts] [9s]
*** SHOW DOWN ***
Douskenov: shows [Jd Jh] (a pair of Jacks)
Cherep1993: shows [8d 8c] (a straight, Six to Ten)
Cherep1993 collected 18694 from pot
Douskenov finished the tournament in 2586th place
*** SUMMARY ***
Total pot 18694 | Rake 0
Board [7h 6c 2s Ts 9s]
Seat 1: borohul8998 folded before Flop (didn't bet)
Seat 2: Douskenov showed [Jd Jh] and lost with a pair of Jacks
Seat 3: Cherep1993 showed [8d 8c] and won (18694) with a straight, Six to Ten
Seat 4: DKerridge14 folded before Flop (didn't bet)
Seat 5: cedricdb95 folded before Flop (didn't bet)
Seat 6: Raddow folded before Flop (didn't bet)
Seat 7: NeCTar222 (button) folded before Flop (didn't bet)
Seat 8: elketefuka (small blind) folded before Flop
Seat 9: TENSAI POKER (big blind) folded on the Flop


*********** # 57 **************
PokerStars Hand #214025353324: Tournament #2896837020, $0.98+$0.12 USD Hold'em No Limit - Level VII (60/120) - 2020/05/17 10:29:28 ET
Table '2896837020 67' 9-max Seat #8 is the button
Seat 1: borohul8998 (1352 in chips)
Seat 3: Cherep1993 (22793 in chips)
Seat 4: DKerridge14 (2955 in chips)
Seat 5: cedricdb95 (6550 in chips)
Seat 6: Raddow (6691 in chips)
Seat 7: NeCTar222 (19077 in chips)
Seat 8: elketefuka (17636 in chips)
Seat 9: TENSAI POKER (3078 in chips)
borohul8998: posts the ante 15
Cherep1993: posts the ante 15
DKerridge14: posts the ante 15
cedricdb95: posts the ante 15
Raddow: posts the ante 15
NeCTar222: posts the ante 15
elketefuka: posts the ante 15
TENSAI POKER: posts the ante 15
TENSAI POKER: posts small blind 60
borohul8998: posts big blind 120
*** HOLE CARDS ***
Dealt to elketefuka [7h 6c]
Cherep1993: folds
DKerridge14: folds
cedricdb95: folds
Raddow: raises 150 to 270
NeCTar222: calls 270
elketefuka: calls 270
TENSAI POKER: raises 2793 to 3063 and is all-in
borohul8998: folds
Raddow: folds
NeCTar222: folds
elketefuka: folds
Uncalled bet (2793) returned to TENSAI POKER
TENSAI POKER collected 1320 from pot
TENSAI POKER: doesn't show hand
*** SUMMARY ***
Total pot 1320 | Rake 0
Seat 1: borohul8998 (big blind) folded before Flop
Seat 3: Cherep1993 folded before Flop (didn't bet)
Seat 4: DKerridge14 folded before Flop (didn't bet)
Seat 5: cedricdb95 folded before Flop (didn't bet)
Seat 6: Raddow folded before Flop
Seat 7: NeCTar222 folded before Flop
Seat 8: elketefuka (button) folded before Flop
Seat 9: TENSAI POKER (small blind) collected (1320)


*********** # 58 **************
PokerStars Hand #214025416370: Tournament #2896837020, $0.98+$0.12 USD Hold'em No Limit - Level VII (60/120) - 2020/05/17 10:30:46 ET
Table '2896837020 67' 9-max Seat #9 is the button
Seat 1: borohul8998 (1217 in chips)
Seat 2: Ten2019 (3000 in chips)
Seat 3: Cherep1993 (22778 in chips)
Seat 4: DKerridge14 (2940 in chips)
Seat 5: cedricdb95 (6535 in chips)
Seat 6: Raddow (6406 in chips)
Seat 7: NeCTar222 (18792 in chips)
Seat 8: elketefuka (17351 in chips)
Seat 9: TENSAI POKER (4113 in chips)
borohul8998: posts the ante 15
Ten2019: posts the ante 15
Cherep1993: posts the ante 15
DKerridge14: posts the ante 15
cedricdb95: posts the ante 15
Raddow: posts the ante 15
NeCTar222: posts the ante 15
elketefuka: posts the ante 15
TENSAI POKER: posts the ante 15
borohul8998: posts small blind 60
Ten2019: posts big blind 120
*** HOLE CARDS ***
Dealt to elketefuka [Jh Qd]
Cherep1993: folds
DKerridge14: folds
cedricdb95 has timed out
cedricdb95: folds
cedricdb95 is sitting out
Raddow: folds
NeCTar222: folds
elketefuka: raises 240 to 360
TENSAI POKER: folds
borohul8998: folds
Ten2019: folds
Uncalled bet (240) returned to elketefuka
elketefuka collected 435 from pot
elketefuka: doesn't show hand
*** SUMMARY ***
Total pot 435 | Rake 0
Seat 1: borohul8998 (small blind) folded before Flop
Seat 2: Ten2019 (big blind) folded before Flop
Seat 3: Cherep1993 folded before Flop (didn't bet)
Seat 4: DKerridge14 folded before Flop (didn't bet)
Seat 5: cedricdb95 folded before Flop (didn't bet)
Seat 6: Raddow folded before Flop (didn't bet)
Seat 7: NeCTar222 folded before Flop (didn't bet)
Seat 8: elketefuka collected (435)
Seat 9: TENSAI POKER (button) folded before Flop (didn't bet)


*********** # 59 **************
PokerStars Hand #214025452491: Tournament #2896837020, $0.98+$0.12 USD Hold'em No Limit - Level VII (60/120) - 2020/05/17 10:31:31 ET
Table '2896837020 67' 9-max Seat #1 is the button
Seat 1: borohul8998 (1142 in chips)
Seat 2: Ten2019 (2865 in chips)
Seat 3: Cherep1993 (22763 in chips)
Seat 4: DKerridge14 (2925 in chips)
Seat 5: cedricdb95 (6520 in chips) is sitting out
Seat 6: Raddow (6391 in chips)
Seat 7: NeCTar222 (18777 in chips)
Seat 8: elketefuka (17651 in chips)
Seat 9: TENSAI POKER (4098 in chips)
borohul8998: posts the ante 15
Ten2019: posts the ante 15
Cherep1993: posts the ante 15
DKerridge14: posts the ante 15
cedricdb95: posts the ante 15
Raddow: posts the ante 15
NeCTar222: posts the ante 15
elketefuka: posts the ante 15
TENSAI POKER: posts the ante 15
Ten2019: posts small blind 60
Cherep1993: posts big blind 120
*** HOLE CARDS ***
Dealt to elketefuka [9c 7d]
DKerridge14: folds
cedricdb95: folds
cedricdb95 has returned
Raddow: folds
NeCTar222: folds
elketefuka: folds
TENSAI POKER: raises 180 to 300
borohul8998: folds
Ten2019: folds
Cherep1993: calls 180
*** FLOP *** [Kc Ac Tc]
Cherep1993: checks
TENSAI POKER: bets 215
Cherep1993: calls 215
*** TURN *** [Kc Ac Tc] [5s]
Cherep1993: checks
TENSAI POKER: checks
*** RIVER *** [Kc Ac Tc 5s] [Js]
Cherep1993: bets 120
TENSAI POKER: raises 1440 to 1560
Cherep1993: folds
Uncalled bet (1440) returned to TENSAI POKER
TENSAI POKER collected 1465 from pot
TENSAI POKER: doesn't show hand
*** SUMMARY ***
Total pot 1465 | Rake 0
Board [Kc Ac Tc 5s Js]
Seat 1: borohul8998 (button) folded before Flop (didn't bet)
Seat 2: Ten2019 (small blind) folded before Flop
Seat 3: Cherep1993 (big blind) folded on the River
Seat 4: DKerridge14 folded before Flop (didn't bet)
Seat 5: cedricdb95 folded before Flop (didn't bet)
Seat 6: Raddow folded before Flop (didn't bet)
Seat 7: NeCTar222 folded before Flop (didn't bet)
Seat 8: elketefuka folded before Flop (didn't bet)
Seat 9: TENSAI POKER collected (1465)


*********** # 60 **************
PokerStars Hand #214025511973: Tournament #2896837020, $0.98+$0.12 USD Hold'em No Limit - Level VIII (75/150) - 2020/05/17 10:32:45 ET
Table '2896837020 67' 9-max Seat #2 is the button
Seat 1: borohul8998 (1127 in chips)
Seat 2: Ten2019 (2790 in chips)
Seat 3: Cherep1993 (22113 in chips)
Seat 4: DKerridge14 (2910 in chips)
Seat 5: cedricdb95 (6505 in chips)
Seat 6: Raddow (6376 in chips)
Seat 7: NeCTar222 (18762 in chips)
Seat 8: elketefuka (17636 in chips)
Seat 9: TENSAI POKER (4913 in chips)
borohul8998: posts the ante 20
Ten2019: posts the ante 20
Cherep1993: posts the ante 20
DKerridge14: posts the ante 20
cedricdb95: posts the ante 20
Raddow: posts the ante 20
NeCTar222: posts the ante 20
elketefuka: posts the ante 20
TENSAI POKER: posts the ante 20
Cherep1993: posts small blind 75
DKerridge14: posts big blind 150
*** HOLE CARDS ***
Dealt to elketefuka [3s 8c]
cedricdb95 has timed out
cedricdb95: folds
cedricdb95 is sitting out
Raddow: folds
NeCTar222: calls 150
elketefuka: folds
TENSAI POKER: folds
borohul8998: folds
Ten2019: calls 150
Cherep1993: folds
DKerridge14: checks
*** FLOP *** [3c 7c Kd]
DKerridge14: bets 202
NeCTar222: calls 202
Ten2019: raises 202 to 404
cedricdb95 has returned
DKerridge14: raises 2336 to 2740 and is all-in
NeCTar222: calls 2538
Ten2019: calls 2216 and is all-in
*** TURN *** [3c 7c Kd] [Qs]
*** RIVER *** [3c 7c Kd Qs] [Qc]
*** SHOW DOWN ***
DKerridge14: shows [Td Kc] (two pair, Kings and Queens)
NeCTar222: shows [6c Ac] (a flush, Ace high)
NeCTar222 collected 240 from side pot
Ten2019: shows [3d Ks] (two pair, Kings and Queens)
NeCTar222 collected 8565 from main pot
DKerridge14 finished the tournament in 2464th place
Ten2019 finished the tournament in 2465th place
*** SUMMARY ***
Total pot 8805 Main pot 8565. Side pot 240. | Rake 0
Board [3c 7c Kd Qs Qc]
Seat 1: borohul8998 folded before Flop (didn't bet)
Seat 2: Ten2019 (button) showed [3d Ks] and lost with two pair, Kings and Queens
Seat 3: Cherep1993 (small blind) folded before Flop
Seat 4: DKerridge14 (big blind) showed [Td Kc] and lost with two pair, Kings and Queens
Seat 5: cedricdb95 folded before Flop (didn't bet)
Seat 6: Raddow folded before Flop (didn't bet)
Seat 7: NeCTar222 showed [6c Ac] and won (8805) with a flush, Ace high
Seat 8: elketefuka folded before Flop (didn't bet)
Seat 9: TENSAI POKER folded before Flop (didn't bet)


*********** # 61 **************
PokerStars Hand #214025557518: Tournament #2896837020, $0.98+$0.12 USD Hold'em No Limit - Level VIII (75/150) - 2020/05/17 10:33:42 ET
Table '2896837020 67' 9-max Seat #3 is the button
Seat 1: borohul8998 (1107 in chips)
Seat 3: Cherep1993 (22018 in chips)
Seat 4: Sckip207 (3000 in chips) out of hand (moved from another table into small blind)
Seat 5: cedricdb95 (6485 in chips)
Seat 6: Raddow (6356 in chips)
Seat 7: NeCTar222 (24657 in chips)
Seat 8: elketefuka (17616 in chips)
Seat 9: TENSAI POKER (4893 in chips)
Sckip207 will be allowed to play after the button
borohul8998: posts the ante 20
Cherep1993: posts the ante 20
cedricdb95: posts the ante 20
Raddow: posts the ante 20
NeCTar222: posts the ante 20
elketefuka: posts the ante 20
TENSAI POKER: posts the ante 20
cedricdb95: posts small blind 75
Raddow: posts big blind 150
*** HOLE CARDS ***
Dealt to elketefuka [7s Ac]
NeCTar222: raises 150 to 300
elketefuka: calls 300
TENSAI POKER: folds
borohul8998: calls 300
Cherep1993: folds
cedricdb95: folds
Raddow: folds
*** FLOP *** [As 8c Kh]
NeCTar222: checks
elketefuka: bets 550
borohul8998: folds
NeCTar222: calls 550
*** TURN *** [As 8c Kh] [6d]
NeCTar222: checks
elketefuka: checks
*** RIVER *** [As 8c Kh 6d] [8s]
NeCTar222: bets 993
elketefuka: calls 993
*** SHOW DOWN ***
NeCTar222: shows [Qd Jd] (a pair of Eights)
elketefuka: shows [7s Ac] (two pair, Aces and Eights)
elketefuka collected 4351 from pot
*** SUMMARY ***
Total pot 4351 | Rake 0
Board [As 8c Kh 6d 8s]
Seat 1: borohul8998 folded on the Flop
Seat 3: Cherep1993 (button) folded before Flop (didn't bet)
Seat 5: cedricdb95 (small blind) folded before Flop
Seat 6: Raddow (big blind) folded before Flop
Seat 7: NeCTar222 showed [Qd Jd] and lost with a pair of Eights
Seat 8: elketefuka showed [7s Ac] and won (4351) with two pair, Aces and Eights
Seat 9: TENSAI POKER folded before Flop (didn't bet)


*********** # 62 **************
PokerStars Hand #214025632578: Tournament #2896837020, $0.98+$0.12 USD Hold'em No Limit - Level VIII (75/150) - 2020/05/17 10:35:15 ET
Table '2896837020 67' 9-max Seat #5 is the button
Seat 1: borohul8998 (787 in chips)
Seat 2: Nazarpoly (10400 in chips)
Seat 3: Cherep1993 (21998 in chips)
Seat 4: Sckip207 (3000 in chips)
Seat 5: cedricdb95 (6390 in chips)
Seat 6: Raddow (6186 in chips)
Seat 7: NeCTar222 (22794 in chips)
Seat 8: elketefuka (20104 in chips)
Seat 9: TENSAI POKER (4873 in chips)
borohul8998: posts the ante 20
Nazarpoly: posts the ante 20
Cherep1993: posts the ante 20
Sckip207: posts the ante 20
cedricdb95: posts the ante 20
Raddow: posts the ante 20
NeCTar222: posts the ante 20
elketefuka: posts the ante 20
TENSAI POKER: posts the ante 20
Raddow: posts small blind 75
NeCTar222: posts big blind 150
*** HOLE CARDS ***
Dealt to elketefuka [6c 7d]
elketefuka: folds
TENSAI POKER: folds
borohul8998: folds
Nazarpoly: folds
Cherep1993: folds
Sckip207: folds
cedricdb95 has timed out
cedricdb95: folds
cedricdb95 is sitting out
Raddow: raises 300 to 450
NeCTar222: calls 300
*** FLOP *** [9s 5d 7s]
Raddow: bets 600
NeCTar222: calls 600
*** TURN *** [9s 5d 7s] [Qh]
Raddow: bets 1200
NeCTar222: calls 1200
*** RIVER *** [9s 5d 7s Qh] [8h]
cedricdb95 has returned
Raddow: checks
NeCTar222: checks
*** SHOW DOWN ***
Raddow: shows [Jd Jc] (a pair of Jacks)
NeCTar222: shows [Js Qs] (a pair of Queens)
NeCTar222 collected 4680 from pot
*** SUMMARY ***
Total pot 4680 | Rake 0
Board [9s 5d 7s Qh 8h]
Seat 1: borohul8998 folded before Flop (didn't bet)
Seat 2: Nazarpoly folded before Flop (didn't bet)
Seat 3: Cherep1993 folded before Flop (didn't bet)
Seat 4: Sckip207 folded before Flop (didn't bet)
Seat 5: cedricdb95 (button) folded before Flop (didn't bet)
Seat 6: Raddow (small blind) showed [Jd Jc] and lost with a pair of Jacks
Seat 7: NeCTar222 (big blind) showed [Js Qs] and won (4680) with a pair of Queens
Seat 8: elketefuka folded before Flop (didn't bet)
Seat 9: TENSAI POKER folded before Flop (didn't bet)


*********** # 63 **************
PokerStars Hand #214025685696: Tournament #2896837020, $0.98+$0.12 USD Hold'em No Limit - Level VIII (75/150) - 2020/05/17 10:36:21 ET
Table '2896837020 67' 9-max Seat #6 is the button
Seat 1: borohul8998 (767 in chips)
Seat 2: Nazarpoly (10380 in chips)
Seat 3: Cherep1993 (21978 in chips)
Seat 4: Sckip207 (2980 in chips)
Seat 5: cedricdb95 (6370 in chips)
Seat 6: Raddow (3916 in chips)
Seat 7: NeCTar222 (25204 in chips)
Seat 8: elketefuka (20084 in chips)
Seat 9: TENSAI POKER (4853 in chips)
borohul8998: posts the ante 20
Nazarpoly: posts the ante 20
Cherep1993: posts the ante 20
Sckip207: posts the ante 20
cedricdb95: posts the ante 20
Raddow: posts the ante 20
NeCTar222: posts the ante 20
elketefuka: posts the ante 20
TENSAI POKER: posts the ante 20
NeCTar222: posts small blind 75
elketefuka: posts big blind 150
*** HOLE CARDS ***
Dealt to elketefuka [Th 5s]
TENSAI POKER: folds
borohul8998: raises 300 to 450
Nazarpoly: raises 300 to 750
Cherep1993: folds
Sckip207: folds
cedricdb95 has timed out
cedricdb95: folds
cedricdb95 is sitting out
Raddow: folds
NeCTar222: folds
elketefuka: folds
borohul8998: calls 297 and is all-in
Uncalled bet (3) returned to Nazarpoly
*** FLOP *** [4s 7c 2c]
*** TURN *** [4s 7c 2c] [9h]
*** RIVER *** [4s 7c 2c 9h] [5c]
*** SHOW DOWN ***
borohul8998: shows [Tc Ac] (a flush, Ace high)
Nazarpoly: shows [Qh Js] (high card Queen)
borohul8998 collected 1899 from pot
*** SUMMARY ***
Total pot 1899 | Rake 0
Board [4s 7c 2c 9h 5c]
Seat 1: borohul8998 showed [Tc Ac] and won (1899) with a flush, Ace high
Seat 2: Nazarpoly showed [Qh Js] and lost with high card Queen
Seat 3: Cherep1993 folded before Flop (didn't bet)
Seat 4: Sckip207 folded before Flop (didn't bet)
Seat 5: cedricdb95 folded before Flop (didn't bet)
Seat 6: Raddow (button) folded before Flop (didn't bet)
Seat 7: NeCTar222 (small blind) folded before Flop
Seat 8: elketefuka (big blind) folded before Flop
Seat 9: TENSAI POKER folded before Flop (didn't bet)


*********** # 64 **************
PokerStars Hand #214025733579: Tournament #2896837020, $0.98+$0.12 USD Hold'em No Limit - Level VIII (75/150) - 2020/05/17 10:37:20 ET
Table '2896837020 67' 9-max Seat #7 is the button
Seat 1: borohul8998 (1899 in chips)
Seat 2: Nazarpoly (9613 in chips)
Seat 3: Cherep1993 (21958 in chips)
Seat 4: Sckip207 (2960 in chips)
Seat 5: cedricdb95 (6350 in chips) is sitting out
Seat 6: Raddow (3896 in chips)
Seat 7: NeCTar222 (25109 in chips)
Seat 8: elketefuka (19914 in chips)
Seat 9: TENSAI POKER (4833 in chips)
borohul8998: posts the ante 20
Nazarpoly: posts the ante 20
Cherep1993: posts the ante 20
Sckip207: posts the ante 20
cedricdb95: posts the ante 20
Raddow: posts the ante 20
NeCTar222: posts the ante 20
elketefuka: posts the ante 20
TENSAI POKER: posts the ante 20
elketefuka: posts small blind 75
TENSAI POKER: posts big blind 150
*** HOLE CARDS ***
Dealt to elketefuka [Td Ts]
borohul8998: folds
Nazarpoly: folds
Cherep1993: folds
Sckip207: folds
cedricdb95: folds
Raddow: raises 225 to 375
NeCTar222: folds
cedricdb95 has returned
elketefuka: calls 300
TENSAI POKER: folds
*** FLOP *** [2d 7s 9s]
elketefuka: bets 650
Raddow: folds
Uncalled bet (650) returned to elketefuka
elketefuka collected 1080 from pot
elketefuka: doesn't show hand
*** SUMMARY ***
Total pot 1080 | Rake 0
Board [2d 7s 9s]
Seat 1: borohul8998 folded before Flop (didn't bet)
Seat 2: Nazarpoly folded before Flop (didn't bet)
Seat 3: Cherep1993 folded before Flop (didn't bet)
Seat 4: Sckip207 folded before Flop (didn't bet)
Seat 5: cedricdb95 folded before Flop (didn't bet)
Seat 6: Raddow folded on the Flop
Seat 7: NeCTar222 (button) folded before Flop (didn't bet)
Seat 8: elketefuka (small blind) collected (1080)
Seat 9: TENSAI POKER (big blind) folded before Flop


*********** # 65 **************
PokerStars Hand #214025770021: Tournament #2896837020, $0.98+$0.12 USD Hold'em No Limit - Level VIII (75/150) - 2020/05/17 10:38:05 ET
Table '2896837020 67' 9-max Seat #8 is the button
Seat 1: borohul8998 (1879 in chips)
Seat 2: Nazarpoly (9593 in chips)
Seat 3: Cherep1993 (21938 in chips)
Seat 4: Sckip207 (2940 in chips)
Seat 5: cedricdb95 (6330 in chips)
Seat 6: Raddow (3501 in chips)
Seat 7: NeCTar222 (25089 in chips)
Seat 8: elketefuka (20599 in chips)
Seat 9: TENSAI POKER (4663 in chips)
borohul8998: posts the ante 20
Nazarpoly: posts the ante 20
Cherep1993: posts the ante 20
Sckip207: posts the ante 20
cedricdb95: posts the ante 20
Raddow: posts the ante 20
NeCTar222: posts the ante 20
elketefuka: posts the ante 20
TENSAI POKER: posts the ante 20
TENSAI POKER: posts small blind 75
borohul8998: posts big blind 150
*** HOLE CARDS ***
Dealt to elketefuka [Ks 3s]
Nazarpoly: folds
Cherep1993: folds
Sckip207: folds
cedricdb95 has timed out
cedricdb95: folds
cedricdb95 is sitting out
Raddow: folds
NeCTar222: calls 150
elketefuka: calls 150
TENSAI POKER: calls 75
borohul8998: checks
*** FLOP *** [4c 6d 7h]
TENSAI POKER: checks
borohul8998: checks
NeCTar222: checks
elketefuka: checks
*** TURN *** [4c 6d 7h] [Qd]
TENSAI POKER: checks
borohul8998: checks
NeCTar222: checks
elketefuka: bets 250
cedricdb95 has returned
TENSAI POKER: folds
borohul8998: calls 250
NeCTar222: calls 250
*** RIVER *** [4c 6d 7h Qd] [Kc]
borohul8998: checks
NeCTar222: checks
elketefuka: bets 650
borohul8998: folds
NeCTar222: folds
Uncalled bet (650) returned to elketefuka
elketefuka collected 1530 from pot
elketefuka: doesn't show hand
*** SUMMARY ***
Total pot 1530 | Rake 0
Board [4c 6d 7h Qd Kc]
Seat 1: borohul8998 (big blind) folded on the River
Seat 2: Nazarpoly folded before Flop (didn't bet)
Seat 3: Cherep1993 folded before Flop (didn't bet)
Seat 4: Sckip207 folded before Flop (didn't bet)
Seat 5: cedricdb95 folded before Flop (didn't bet)
Seat 6: Raddow folded before Flop (didn't bet)
Seat 7: NeCTar222 folded on the River
Seat 8: elketefuka (button) collected (1530)
Seat 9: TENSAI POKER (small blind) folded on the Turn


*********** # 66 **************
PokerStars Hand #214025857759: Tournament #2896837020, $0.98+$0.12 USD Hold'em No Limit - Level VIII (75/150) - 2020/05/17 10:39:55 ET
Table '2896837020 67' 9-max Seat #9 is the button
Seat 1: borohul8998 (1459 in chips)
Seat 2: Nazarpoly (9573 in chips)
Seat 3: Cherep1993 (21918 in chips)
Seat 4: Sckip207 (2920 in chips)
Seat 5: cedricdb95 (6310 in chips)
Seat 6: Raddow (3481 in chips)
Seat 7: NeCTar222 (24669 in chips)
Seat 8: elketefuka (21709 in chips)
Seat 9: TENSAI POKER (4493 in chips)
borohul8998: posts the ante 20
Nazarpoly: posts the ante 20
Cherep1993: posts the ante 20
Sckip207: posts the ante 20
cedricdb95: posts the ante 20
Raddow: posts the ante 20
NeCTar222: posts the ante 20
elketefuka: posts the ante 20
TENSAI POKER: posts the ante 20
borohul8998: posts small blind 75
Nazarpoly: posts big blind 150
*** HOLE CARDS ***
Dealt to elketefuka [4d Jh]
Cherep1993: folds
Sckip207: folds
cedricdb95: folds
Raddow: folds
NeCTar222: calls 150
elketefuka: folds
TENSAI POKER: folds
borohul8998: calls 75
Nazarpoly: checks
*** FLOP *** [5d Ah 3h]
borohul8998: checks
Nazarpoly: bets 1500
NeCTar222: calls 1500
borohul8998: calls 1289 and is all-in
*** TURN *** [5d Ah 3h] [Td]
Nazarpoly: checks
NeCTar222: checks
*** RIVER *** [5d Ah 3h Td] [Qd]
Nazarpoly: checks
NeCTar222: checks
*** SHOW DOWN ***
Nazarpoly: shows [6h Ac] (a pair of Aces)
NeCTar222: mucks hand
Nazarpoly collected 422 from side pot
borohul8998: shows [As 7d] (a pair of Aces - Queen+Ten+Seven kicker)
borohul8998 collected 4497 from main pot
*** SUMMARY ***
Total pot 4919 Main pot 4497. Side pot 422. | Rake 0
Board [5d Ah 3h Td Qd]
Seat 1: borohul8998 (small blind) showed [As 7d] and won (4497) with a pair of Aces
Seat 2: Nazarpoly (big blind) showed [6h Ac] and won (422) with a pair of Aces
Seat 3: Cherep1993 folded before Flop (didn't bet)
Seat 4: Sckip207 folded before Flop (didn't bet)
Seat 5: cedricdb95 folded before Flop (didn't bet)
Seat 6: Raddow folded before Flop (didn't bet)
Seat 7: NeCTar222 mucked [2d 2s]
Seat 8: elketefuka folded before Flop (didn't bet)
Seat 9: TENSAI POKER (button) folded before Flop (didn't bet)


*********** # 67 **************
PokerStars Hand #214025915433: Tournament #2896837020, $0.98+$0.12 USD Hold'em No Limit - Level VIII (75/150) - 2020/05/17 10:41:07 ET
Table '2896837020 67' 9-max Seat #1 is the button
Seat 1: borohul8998 (4497 in chips)
Seat 2: Nazarpoly (8325 in chips)
Seat 3: Cherep1993 (21898 in chips)
Seat 4: Sckip207 (2900 in chips)
Seat 5: cedricdb95 (6290 in chips)
Seat 6: Raddow (3461 in chips)
Seat 7: NeCTar222 (22999 in chips)
Seat 8: elketefuka (21689 in chips)
Seat 9: TENSAI POKER (4473 in chips)
borohul8998: posts the ante 20
Nazarpoly: posts the ante 20
Cherep1993: posts the ante 20
Sckip207: posts the ante 20
cedricdb95: posts the ante 20
Raddow: posts the ante 20
NeCTar222: posts the ante 20
elketefuka: posts the ante 20
TENSAI POKER: posts the ante 20
Nazarpoly: posts small blind 75
Cherep1993: posts big blind 150
*** HOLE CARDS ***
Dealt to elketefuka [8h 6c]
Sckip207: folds
cedricdb95: calls 150
Raddow: folds
NeCTar222: folds
elketefuka: folds
TENSAI POKER: folds
borohul8998: folds
Nazarpoly: raises 150 to 300
Cherep1993: folds
cedricdb95: calls 150
*** FLOP *** [8c 3h Ks]
Nazarpoly: bets 1000
cedricdb95: folds
Uncalled bet (1000) returned to Nazarpoly
Nazarpoly collected 930 from pot
Nazarpoly: doesn't show hand
*** SUMMARY ***
Total pot 930 | Rake 0
Board [8c 3h Ks]
Seat 1: borohul8998 (button) folded before Flop (didn't bet)
Seat 2: Nazarpoly (small blind) collected (930)
Seat 3: Cherep1993 (big blind) folded before Flop
Seat 4: Sckip207 folded before Flop (didn't bet)
Seat 5: cedricdb95 folded on the Flop
Seat 6: Raddow folded before Flop (didn't bet)
Seat 7: NeCTar222 folded before Flop (didn't bet)
Seat 8: elketefuka folded before Flop (didn't bet)
Seat 9: TENSAI POKER folded before Flop (didn't bet)


*********** # 68 **************
PokerStars Hand #214025955186: Tournament #2896837020, $0.98+$0.12 USD Hold'em No Limit - Level IX (100/200) - 2020/05/17 10:41:56 ET
Table '2896837020 67' 9-max Seat #2 is the button
Seat 1: borohul8998 (4477 in chips)
Seat 2: Nazarpoly (8935 in chips)
Seat 3: Cherep1993 (21728 in chips)
Seat 4: Sckip207 (2880 in chips)
Seat 5: cedricdb95 (5970 in chips)
Seat 6: Raddow (3441 in chips)
Seat 7: NeCTar222 (22979 in chips)
Seat 8: elketefuka (21669 in chips)
Seat 9: TENSAI POKER (4453 in chips)
borohul8998: posts the ante 25
Nazarpoly: posts the ante 25
Cherep1993: posts the ante 25
Sckip207: posts the ante 25
cedricdb95: posts the ante 25
Raddow: posts the ante 25
NeCTar222: posts the ante 25
elketefuka: posts the ante 25
TENSAI POKER: posts the ante 25
Cherep1993: posts small blind 100
Sckip207: posts big blind 200
*** HOLE CARDS ***
Dealt to elketefuka [5d Qd]
cedricdb95: folds
Raddow: raises 3216 to 3416 and is all-in
NeCTar222: folds
elketefuka: folds
TENSAI POKER: folds
borohul8998: calls 3416
Nazarpoly: calls 3416
Cherep1993: folds
Sckip207: folds
*** FLOP *** [3h 3d 5s]
borohul8998: checks
Nazarpoly: bets 1050
borohul8998: folds
Uncalled bet (1050) returned to Nazarpoly
*** TURN *** [3h 3d 5s] [Qs]
*** RIVER *** [3h 3d 5s Qs] [Jh]
*** SHOW DOWN ***
Raddow: shows [Ts Th] (two pair, Tens and Threes)
Nazarpoly: shows [Ac Kc] (a pair of Threes)
Raddow collected 10773 from pot
*** SUMMARY ***
Total pot 10773 | Rake 0
Board [3h 3d 5s Qs Jh]
Seat 1: borohul8998 folded on the Flop
Seat 2: Nazarpoly (button) showed [Ac Kc] and lost with a pair of Threes
Seat 3: Cherep1993 (small blind) folded before Flop
Seat 4: Sckip207 (big blind) folded before Flop
Seat 5: cedricdb95 folded before Flop (didn't bet)
Seat 6: Raddow showed [Ts Th] and won (10773) with two pair, Tens and Threes
Seat 7: NeCTar222 folded before Flop (didn't bet)
Seat 8: elketefuka folded before Flop (didn't bet)
Seat 9: TENSAI POKER folded before Flop (didn't bet)


*********** # 69 **************
PokerStars Hand #214026004708: Tournament #2896837020, $0.98+$0.12 USD Hold'em No Limit - Level IX (100/200) - 2020/05/17 10:42:57 ET
Table '2896837020 67' 9-max Seat #3 is the button
Seat 1: borohul8998 (1036 in chips)
Seat 2: Nazarpoly (5494 in chips)
Seat 3: Cherep1993 (21603 in chips)
Seat 4: Sckip207 (2655 in chips)
Seat 5: cedricdb95 (5945 in chips)
Seat 6: Raddow (10773 in chips)
Seat 7: NeCTar222 (22954 in chips)
Seat 8: elketefuka (21644 in chips)
Seat 9: TENSAI POKER (4428 in chips)
borohul8998: posts the ante 25
Nazarpoly: posts the ante 25
Cherep1993: posts the ante 25
Sckip207: posts the ante 25
cedricdb95: posts the ante 25
Raddow: posts the ante 25
NeCTar222: posts the ante 25
elketefuka: posts the ante 25
TENSAI POKER: posts the ante 25
Sckip207: posts small blind 100
cedricdb95: posts big blind 200
*** HOLE CARDS ***
Dealt to elketefuka [Ks 8h]
Raddow: folds
NeCTar222: folds
elketefuka: raises 200 to 400
TENSAI POKER: folds
borohul8998: calls 400
Nazarpoly: calls 400
Cherep1993: folds
Sckip207: folds
cedricdb95 has timed out
cedricdb95: folds
cedricdb95 is sitting out
*** FLOP *** [Kh 9h 3s]
cedricdb95 has returned
elketefuka: bets 900
borohul8998: folds
Nazarpoly: raises 4169 to 5069 and is all-in
elketefuka: calls 4169
*** TURN *** [Kh 9h 3s] [Tc]
*** RIVER *** [Kh 9h 3s Tc] [8d]
*** SHOW DOWN ***
elketefuka: shows [Ks 8h] (two pair, Kings and Eights)
Nazarpoly: shows [Jh Kc] (a pair of Kings)
elketefuka collected 11863 from pot
Nazarpoly finished the tournament in 2095th place
*** SUMMARY ***
Total pot 11863 | Rake 0
Board [Kh 9h 3s Tc 8d]
Seat 1: borohul8998 folded on the Flop
Seat 2: Nazarpoly showed [Jh Kc] and lost with a pair of Kings
Seat 3: Cherep1993 (button) folded before Flop (didn't bet)
Seat 4: Sckip207 (small blind) folded before Flop
Seat 5: cedricdb95 (big blind) folded before Flop
Seat 6: Raddow folded before Flop (didn't bet)
Seat 7: NeCTar222 folded before Flop (didn't bet)
Seat 8: elketefuka showed [Ks 8h] and won (11863) with two pair, Kings and Eights
Seat 9: TENSAI POKER folded before Flop (didn't bet)


*********** # 70 **************
PokerStars Hand #214026066114: Tournament #2896837020, $0.98+$0.12 USD Hold'em No Limit - Level IX (100/200) - 2020/05/17 10:44:09 ET
Table '2896837020 67' 9-max Seat #4 is the button
Seat 1: borohul8998 (611 in chips)
Seat 3: Cherep1993 (21578 in chips)
Seat 4: Sckip207 (2530 in chips)
Seat 5: cedricdb95 (5720 in chips)
Seat 6: Raddow (10748 in chips)
Seat 7: NeCTar222 (22929 in chips)
Seat 8: elketefuka (28013 in chips)
Seat 9: TENSAI POKER (4403 in chips)
borohul8998: posts the ante 25
Cherep1993: posts the ante 25
Sckip207: posts the ante 25
cedricdb95: posts the ante 25
Raddow: posts the ante 25
NeCTar222: posts the ante 25
elketefuka: posts the ante 25
TENSAI POKER: posts the ante 25
cedricdb95: posts small blind 100
Raddow: posts big blind 200
*** HOLE CARDS ***
Dealt to elketefuka [5c Ks]
NeCTar222: calls 200
elketefuka: calls 200
TENSAI POKER: folds
borohul8998: calls 200
Cherep1993: folds
Sckip207: folds
cedricdb95: calls 100
Raddow: checks
*** FLOP *** [Jh 2c 4d]
cedricdb95: checks
Raddow: checks
NeCTar222: checks
elketefuka: checks
borohul8998: checks
*** TURN *** [Jh 2c 4d] [3c]
cedricdb95: checks
Raddow: checks
NeCTar222: checks
elketefuka: bets 400
borohul8998: folds
cedricdb95: folds
Raddow: folds
NeCTar222: folds
Uncalled bet (400) returned to elketefuka
elketefuka collected 1200 from pot
elketefuka: doesn't show hand
*** SUMMARY ***
Total pot 1200 | Rake 0
Board [Jh 2c 4d 3c]
Seat 1: borohul8998 folded on the Turn
Seat 3: Cherep1993 folded before Flop (didn't bet)
Seat 4: Sckip207 (button) folded before Flop (didn't bet)
Seat 5: cedricdb95 (small blind) folded on the Turn
Seat 6: Raddow (big blind) folded on the Turn
Seat 7: NeCTar222 folded on the Turn
Seat 8: elketefuka collected (1200)
Seat 9: TENSAI POKER folded before Flop (didn't bet)


*********** # 71 **************
PokerStars Hand #214026130259: Tournament #2896837020, $0.98+$0.12 USD Hold'em No Limit - Level IX (100/200) - 2020/05/17 10:45:27 ET
Table '2896837020 67' 9-max Seat #5 is the button
Seat 1: borohul8998 (386 in chips)
Seat 2: Mars dlhe (3000 in chips)
Seat 3: Cherep1993 (21553 in chips)
Seat 4: Sckip207 (2505 in chips)
Seat 5: cedricdb95 (5495 in chips)
Seat 6: Raddow (10523 in chips)
Seat 7: NeCTar222 (22704 in chips)
Seat 8: elketefuka (28988 in chips)
Seat 9: TENSAI POKER (4378 in chips)
borohul8998: posts the ante 25
Mars dlhe: posts the ante 25
Cherep1993: posts the ante 25
Sckip207: posts the ante 25
cedricdb95: posts the ante 25
Raddow: posts the ante 25
NeCTar222: posts the ante 25
elketefuka: posts the ante 25
TENSAI POKER: posts the ante 25
Raddow: posts small blind 100
NeCTar222: posts big blind 200
*** HOLE CARDS ***
Dealt to elketefuka [8s 5h]
elketefuka: folds
TENSAI POKER: folds
borohul8998: folds
Mars dlhe: folds
Cherep1993: raises 200 to 400
Sckip207: folds
cedricdb95: folds
Raddow: folds
NeCTar222: calls 200
*** FLOP *** [Jh Td Qh]
NeCTar222: checks
Cherep1993: checks
*** TURN *** [Jh Td Qh] [5d]
NeCTar222: checks
Cherep1993: checks
*** RIVER *** [Jh Td Qh 5d] [2d]
NeCTar222: bets 400
Cherep1993: calls 400
*** SHOW DOWN ***
NeCTar222: shows [Tc 7d] (a pair of Tens)
Cherep1993: mucks hand
NeCTar222 collected 1925 from pot
*** SUMMARY ***
Total pot 1925 | Rake 0
Board [Jh Td Qh 5d 2d]
Seat 1: borohul8998 folded before Flop (didn't bet)
Seat 2: Mars dlhe folded before Flop (didn't bet)
Seat 3: Cherep1993 mucked [5c As]
Seat 4: Sckip207 folded before Flop (didn't bet)
Seat 5: cedricdb95 (button) folded before Flop (didn't bet)
Seat 6: Raddow (small blind) folded before Flop
Seat 7: NeCTar222 (big blind) showed [Tc 7d] and won (1925) with a pair of Tens
Seat 8: elketefuka folded before Flop (didn't bet)
Seat 9: TENSAI POKER folded before Flop (didn't bet)


*********** # 72 **************
PokerStars Hand #214026172197: Tournament #2896837020, $0.98+$0.12 USD Hold'em No Limit - Level IX (100/200) - 2020/05/17 10:46:18 ET
Table '2896837020 67' 9-max Seat #6 is the button
Seat 1: borohul8998 (361 in chips)
Seat 2: Mars dlhe (2975 in chips)
Seat 3: Cherep1993 (20728 in chips)
Seat 4: Sckip207 (2480 in chips)
Seat 5: cedricdb95 (5470 in chips)
Seat 6: Raddow (10398 in chips)
Seat 7: NeCTar222 (23804 in chips)
Seat 8: elketefuka (28963 in chips)
Seat 9: TENSAI POKER (4353 in chips)
borohul8998: posts the ante 25
Mars dlhe: posts the ante 25
Cherep1993: posts the ante 25
Sckip207: posts the ante 25
cedricdb95: posts the ante 25
Raddow: posts the ante 25
NeCTar222: posts the ante 25
elketefuka: posts the ante 25
TENSAI POKER: posts the ante 25
NeCTar222: posts small blind 100
elketefuka: posts big blind 200
*** HOLE CARDS ***
Dealt to elketefuka [Jd 4c]
TENSAI POKER: folds
borohul8998: folds
Mars dlhe: calls 200
Cherep1993: folds
Sckip207: folds
cedricdb95: folds
Raddow: raises 500 to 700
NeCTar222: folds
elketefuka: folds
Mars dlhe: raises 2250 to 2950 and is all-in
Raddow: calls 2250
*** FLOP *** [6h Th 9d]
*** TURN *** [6h Th 9d] [As]
*** RIVER *** [6h Th 9d As] [5c]
*** SHOW DOWN ***
Mars dlhe: shows [5h Ac] (two pair, Aces and Fives)
Raddow: shows [Kh Qs] (high card Ace)
Mars dlhe collected 6425 from pot
*** SUMMARY ***
Total pot 6425 | Rake 0
Board [6h Th 9d As 5c]
Seat 1: borohul8998 folded before Flop (didn't bet)
Seat 2: Mars dlhe showed [5h Ac] and won (6425) with two pair, Aces and Fives
Seat 3: Cherep1993 folded before Flop (didn't bet)
Seat 4: Sckip207 folded before Flop (didn't bet)
Seat 5: cedricdb95 folded before Flop (didn't bet)
Seat 6: Raddow (button) showed [Kh Qs] and lost with high card Ace
Seat 7: NeCTar222 (small blind) folded before Flop
Seat 8: elketefuka (big blind) folded before Flop
Seat 9: TENSAI POKER folded before Flop (didn't bet)


*********** # 73 **************
PokerStars Hand #214026237760: Tournament #2896837020, $0.98+$0.12 USD Hold'em No Limit - Level IX (100/200) - 2020/05/17 10:47:38 ET
Table '2896837020 67' 9-max Seat #7 is the button
Seat 1: borohul8998 (336 in chips)
Seat 2: Mars dlhe (6425 in chips)
Seat 3: Cherep1993 (20703 in chips)
Seat 4: Sckip207 (2455 in chips)
Seat 5: cedricdb95 (5445 in chips)
Seat 6: Raddow (7423 in chips)
Seat 7: NeCTar222 (23679 in chips)
Seat 8: elketefuka (28738 in chips)
Seat 9: TENSAI POKER (4328 in chips)
borohul8998: posts the ante 25
Mars dlhe: posts the ante 25
Cherep1993: posts the ante 25
Sckip207: posts the ante 25
cedricdb95: posts the ante 25
Raddow: posts the ante 25
NeCTar222: posts the ante 25
elketefuka: posts the ante 25
TENSAI POKER: posts the ante 25
elketefuka: posts small blind 100
TENSAI POKER: posts big blind 200
*** HOLE CARDS ***
Dealt to elketefuka [2c 3c]
borohul8998: folds
Mars dlhe: raises 200 to 400
Cherep1993: folds
Sckip207: calls 400
cedricdb95: folds
Raddow: folds
NeCTar222: folds
elketefuka: calls 300
TENSAI POKER: calls 200
*** FLOP *** [7s 9d 4s]
elketefuka: checks
TENSAI POKER: checks
Mars dlhe: bets 800
Sckip207: folds
elketefuka: folds
TENSAI POKER: folds
Uncalled bet (800) returned to Mars dlhe
Mars dlhe collected 1825 from pot
Mars dlhe: doesn't show hand
*** SUMMARY ***
Total pot 1825 | Rake 0
Board [7s 9d 4s]
Seat 1: borohul8998 folded before Flop (didn't bet)
Seat 2: Mars dlhe collected (1825)
Seat 3: Cherep1993 folded before Flop (didn't bet)
Seat 4: Sckip207 folded on the Flop
Seat 5: cedricdb95 folded before Flop (didn't bet)
Seat 6: Raddow folded before Flop (didn't bet)
Seat 7: NeCTar222 (button) folded before Flop (didn't bet)
Seat 8: elketefuka (small blind) folded on the Flop
Seat 9: TENSAI POKER (big blind) folded on the Flop


*********** # 74 **************
PokerStars Hand #214026302584: Tournament #2896837020, $0.98+$0.12 USD Hold'em No Limit - Level IX (100/200) - 2020/05/17 10:48:57 ET
Table '2896837020 67' 9-max Seat #8 is the button
Seat 1: borohul8998 (311 in chips)
Seat 2: Mars dlhe (7825 in chips)
Seat 3: Cherep1993 (20678 in chips)
Seat 4: Sckip207 (2030 in chips)
Seat 5: cedricdb95 (5420 in chips)
Seat 6: Raddow (7398 in chips)
Seat 7: NeCTar222 (23654 in chips)
Seat 8: elketefuka (28313 in chips)
Seat 9: TENSAI POKER (3903 in chips)
borohul8998: posts the ante 25
Mars dlhe: posts the ante 25
Cherep1993: posts the ante 25
Sckip207: posts the ante 25
cedricdb95: posts the ante 25
Raddow: posts the ante 25
NeCTar222: posts the ante 25
elketefuka: posts the ante 25
TENSAI POKER: posts the ante 25
TENSAI POKER: posts small blind 100
borohul8998: posts big blind 200
*** HOLE CARDS ***
Dealt to elketefuka [7h 6c]
Mars dlhe: folds
Cherep1993: folds
Sckip207: raises 1805 to 2005 and is all-in
cedricdb95: folds
Raddow: folds
NeCTar222: folds
elketefuka: folds
TENSAI POKER: raises 1873 to 3878 and is all-in
borohul8998: calls 86 and is all-in
Uncalled bet (1873) returned to TENSAI POKER
*** FLOP *** [8c 2s Jc]
*** TURN *** [8c 2s Jc] [9d]
*** RIVER *** [8c 2s Jc 9d] [4h]
*** SHOW DOWN ***
TENSAI POKER: shows [Jh As] (a pair of Jacks)
Sckip207: shows [Ks 7s] (high card King)
TENSAI POKER collected 3438 from side pot
borohul8998: shows [Td Ad] (high card Ace)
TENSAI POKER collected 1083 from main pot
Sckip207 finished the tournament in 1876th place
borohul8998 finished the tournament in 1877th place
*** SUMMARY ***
Total pot 4521 Main pot 1083. Side pot 3438. | Rake 0
Board [8c 2s Jc 9d 4h]
Seat 1: borohul8998 (big blind) showed [Td Ad] and lost with high card Ace
Seat 2: Mars dlhe folded before Flop (didn't bet)
Seat 3: Cherep1993 folded before Flop (didn't bet)
Seat 4: Sckip207 showed [Ks 7s] and lost with high card King
Seat 5: cedricdb95 folded before Flop (didn't bet)
Seat 6: Raddow folded before Flop (didn't bet)
Seat 7: NeCTar222 folded before Flop (didn't bet)
Seat 8: elketefuka (button) folded before Flop (didn't bet)
Seat 9: TENSAI POKER (small blind) showed [Jh As] and won (4521) with a pair of Jacks


*********** # 75 **************
PokerStars Hand #214026337232: Tournament #2896837020, $0.98+$0.12 USD Hold'em No Limit - Level IX (100/200) - 2020/05/17 10:49:39 ET
Table '2896837020 67' 9-max Seat #9 is the button
Seat 1: dubskanker (2746 in chips) out of hand (moved from another table into small blind)
Seat 2: Mars dlhe (7800 in chips)
Seat 3: Cherep1993 (20653 in chips)
Seat 5: cedricdb95 (5395 in chips)
Seat 6: Raddow (7373 in chips)
Seat 7: NeCTar222 (23629 in chips)
Seat 8: elketefuka (28288 in chips)
Seat 9: TENSAI POKER (6394 in chips)
dubskanker will be allowed to play after the button
Mars dlhe: posts the ante 25
Cherep1993: posts the ante 25
cedricdb95: posts the ante 25
Raddow: posts the ante 25
NeCTar222: posts the ante 25
elketefuka: posts the ante 25
TENSAI POKER: posts the ante 25
Mars dlhe: posts small blind 100
Cherep1993: posts big blind 200
*** HOLE CARDS ***
Dealt to elketefuka [9h Ad]
cedricdb95: folds
Raddow: folds
NeCTar222: folds
elketefuka: raises 200 to 400
TENSAI POKER: raises 800 to 1200
Mars dlhe: folds
Cherep1993: folds
elketefuka: folds
Uncalled bet (800) returned to TENSAI POKER
TENSAI POKER collected 1275 from pot
TENSAI POKER: doesn't show hand
*** SUMMARY ***
Total pot 1275 | Rake 0
Seat 2: Mars dlhe (small blind) folded before Flop
Seat 3: Cherep1993 (big blind) folded before Flop
Seat 5: cedricdb95 folded before Flop (didn't bet)
Seat 6: Raddow folded before Flop (didn't bet)
Seat 7: NeCTar222 folded before Flop (didn't bet)
Seat 8: elketefuka folded before Flop
Seat 9: TENSAI POKER (button) collected (1275)


*********** # 76 **************
PokerStars Hand #214026374866: Tournament #2896837020, $0.98+$0.12 USD Hold'em No Limit - Level IX (100/200) - 2020/05/17 10:50:25 ET
Table '2896837020 67' 9-max Seat #2 is the button
Seat 1: dubskanker (2746 in chips)
Seat 2: Mars dlhe (7675 in chips)
Seat 3: Cherep1993 (20428 in chips)
Seat 4: passat1g (3000 in chips)
Seat 5: cedricdb95 (5370 in chips)
Seat 6: Raddow (7348 in chips)
Seat 7: NeCTar222 (23604 in chips)
Seat 8: elketefuka (27863 in chips)
Seat 9: TENSAI POKER (7244 in chips)
dubskanker: posts the ante 25
Mars dlhe: posts the ante 25
Cherep1993: posts the ante 25
passat1g: posts the ante 25
cedricdb95: posts the ante 25
Raddow: posts the ante 25
NeCTar222: posts the ante 25
elketefuka: posts the ante 25
TENSAI POKER: posts the ante 25
Cherep1993: posts small blind 100
passat1g: posts big blind 200
*** HOLE CARDS ***
Dealt to elketefuka [9s 2h]
cedricdb95 has timed out
cedricdb95: folds
cedricdb95 is sitting out
Raddow: folds
cedricdb95 has returned
NeCTar222: folds
elketefuka: folds
TENSAI POKER: folds
dubskanker: folds
Mars dlhe: folds
Cherep1993: folds
Uncalled bet (100) returned to passat1g
passat1g collected 425 from pot
*** SUMMARY ***
Total pot 425 | Rake 0
Seat 1: dubskanker folded before Flop (didn't bet)
Seat 2: Mars dlhe (button) folded before Flop (didn't bet)
Seat 3: Cherep1993 (small blind) folded before Flop
Seat 4: passat1g (big blind) collected (425)
Seat 5: cedricdb95 folded before Flop (didn't bet)
Seat 6: Raddow folded before Flop (didn't bet)
Seat 7: NeCTar222 folded before Flop (didn't bet)
Seat 8: elketefuka folded before Flop (didn't bet)
Seat 9: TENSAI POKER folded before Flop (didn't bet)


*********** # 77 **************
PokerStars Hand #214026414930: Tournament #2896837020, $0.98+$0.12 USD Hold'em No Limit - Level IX (100/200) - 2020/05/17 10:51:13 ET
Table '2896837020 67' 9-max Seat #3 is the button
Seat 1: dubskanker (2721 in chips)
Seat 2: Mars dlhe (7650 in chips)
Seat 3: Cherep1993 (20303 in chips)
Seat 4: passat1g (3300 in chips)
Seat 5: cedricdb95 (5345 in chips)
Seat 6: Raddow (7323 in chips)
Seat 7: NeCTar222 (23579 in chips)
Seat 8: elketefuka (27838 in chips)
Seat 9: TENSAI POKER (7219 in chips)
dubskanker: posts the ante 25
Mars dlhe: posts the ante 25
Cherep1993: posts the ante 25
passat1g: posts the ante 25
cedricdb95: posts the ante 25
Raddow: posts the ante 25
NeCTar222: posts the ante 25
elketefuka: posts the ante 25
TENSAI POKER: posts the ante 25
passat1g: posts small blind 100
cedricdb95: posts big blind 200
*** HOLE CARDS ***
Dealt to elketefuka [Kd 2d]
Raddow: folds
NeCTar222: folds
elketefuka: calls 200
TENSAI POKER: folds
dubskanker: folds
Mars dlhe: raises 400 to 600
Cherep1993: folds
passat1g: folds
cedricdb95: folds
elketefuka: calls 400
*** FLOP *** [7c Tc 5s]
elketefuka: checks
Mars dlhe: bets 600
elketefuka: folds
Uncalled bet (600) returned to Mars dlhe
Mars dlhe collected 1725 from pot
Mars dlhe: doesn't show hand
*** SUMMARY ***
Total pot 1725 | Rake 0
Board [7c Tc 5s]
Seat 1: dubskanker folded before Flop (didn't bet)
Seat 2: Mars dlhe collected (1725)
Seat 3: Cherep1993 (button) folded before Flop (didn't bet)
Seat 4: passat1g (small blind) folded before Flop
Seat 5: cedricdb95 (big blind) folded before Flop
Seat 6: Raddow folded before Flop (didn't bet)
Seat 7: NeCTar222 folded before Flop (didn't bet)
Seat 8: elketefuka folded on the Flop
Seat 9: TENSAI POKER folded before Flop (didn't bet)


*********** # 78 **************
PokerStars Hand #214026465235: Tournament #2896837020, $0.98+$0.12 USD Hold'em No Limit - Level X (125/250) - 2020/05/17 10:52:12 ET
Table '2896837020 67' 9-max Seat #4 is the button
Seat 1: dubskanker (2696 in chips)
Seat 2: Mars dlhe (8750 in chips)
Seat 3: Cherep1993 (20278 in chips)
Seat 4: passat1g (3175 in chips)
Seat 5: cedricdb95 (5120 in chips)
Seat 6: Raddow (7298 in chips)
Seat 7: NeCTar222 (23554 in chips)
Seat 8: elketefuka (27213 in chips)
Seat 9: TENSAI POKER (7194 in chips)
dubskanker: posts the ante 30
Mars dlhe: posts the ante 30
Cherep1993: posts the ante 30
passat1g: posts the ante 30
cedricdb95: posts the ante 30
Raddow: posts the ante 30
NeCTar222: posts the ante 30
elketefuka: posts the ante 30
TENSAI POKER: posts the ante 30
cedricdb95: posts small blind 125
Raddow: posts big blind 250
*** HOLE CARDS ***
Dealt to elketefuka [9d 2s]
NeCTar222: folds
elketefuka: folds
TENSAI POKER: folds
dubskanker: folds
Mars dlhe: folds
Cherep1993: raises 500 to 750
passat1g: folds
cedricdb95: calls 625
Raddow: folds
*** FLOP *** [3s Kc Qd]
cedricdb95: bets 750
Cherep1993: calls 750
*** TURN *** [3s Kc Qd] [Ac]
cedricdb95: bets 1750
Cherep1993: calls 1750
*** RIVER *** [3s Kc Qd Ac] [7h]
cedricdb95: bets 1840 and is all-in
Cherep1993: folds [Td Th]
Uncalled bet (1840) returned to cedricdb95
cedricdb95 collected 7020 from pot
*** SUMMARY ***
Total pot 7020 | Rake 0
Board [3s Kc Qd Ac 7h]
Seat 1: dubskanker folded before Flop (didn't bet)
Seat 2: Mars dlhe folded before Flop (didn't bet)
Seat 3: Cherep1993 folded on the River
Seat 4: passat1g (button) folded before Flop (didn't bet)
Seat 5: cedricdb95 (small blind) collected (7020)
Seat 6: Raddow (big blind) folded before Flop
Seat 7: NeCTar222 folded before Flop (didn't bet)
Seat 8: elketefuka folded before Flop (didn't bet)
Seat 9: TENSAI POKER folded before Flop (didn't bet)


*********** # 79 **************
PokerStars Hand #214026511994: Tournament #2896837020, $0.98+$0.12 USD Hold'em No Limit - Level X (125/250) - 2020/05/17 10:53:09 ET
Table '2896837020 67' 9-max Seat #5 is the button
Seat 1: dubskanker (2666 in chips)
Seat 2: Mars dlhe (8720 in chips)
Seat 3: Cherep1993 (16998 in chips)
Seat 4: passat1g (3145 in chips)
Seat 5: cedricdb95 (8860 in chips)
Seat 6: Raddow (7018 in chips)
Seat 7: NeCTar222 (23524 in chips)
Seat 8: elketefuka (27183 in chips)
Seat 9: TENSAI POKER (7164 in chips)
dubskanker: posts the ante 30
Mars dlhe: posts the ante 30
Cherep1993: posts the ante 30
passat1g: posts the ante 30
cedricdb95: posts the ante 30
Raddow: posts the ante 30
NeCTar222: posts the ante 30
elketefuka: posts the ante 30
TENSAI POKER: posts the ante 30
Raddow: posts small blind 125
NeCTar222: posts big blind 250
*** HOLE CARDS ***
Dealt to elketefuka [6s 2s]
elketefuka: folds
TENSAI POKER: folds
dubskanker: raises 2386 to 2636 and is all-in
Mars dlhe: folds
Cherep1993: folds
passat1g: folds
cedricdb95: folds
Raddow: folds
NeCTar222: folds
Uncalled bet (2386) returned to dubskanker
dubskanker collected 895 from pot
dubskanker: doesn't show hand
*** SUMMARY ***
Total pot 895 | Rake 0
Seat 1: dubskanker collected (895)
Seat 2: Mars dlhe folded before Flop (didn't bet)
Seat 3: Cherep1993 folded before Flop (didn't bet)
Seat 4: passat1g folded before Flop (didn't bet)
Seat 5: cedricdb95 (button) folded before Flop (didn't bet)
Seat 6: Raddow (small blind) folded before Flop
Seat 7: NeCTar222 (big blind) folded before Flop
Seat 8: elketefuka folded before Flop (didn't bet)
Seat 9: TENSAI POKER folded before Flop (didn't bet)


*********** # 80 **************
PokerStars Hand #214026536629: Tournament #2896837020, $0.98+$0.12 USD Hold'em No Limit - Level X (125/250) - 2020/05/17 10:53:39 ET
Table '2896837020 67' 9-max Seat #6 is the button
Seat 1: dubskanker (3281 in chips)
Seat 2: Mars dlhe (8690 in chips)
Seat 3: Cherep1993 (16968 in chips)
Seat 4: passat1g (3115 in chips)
Seat 5: cedricdb95 (8830 in chips)
Seat 6: Raddow (6863 in chips)
Seat 7: NeCTar222 (23244 in chips)
Seat 8: elketefuka (27153 in chips)
Seat 9: TENSAI POKER (7134 in chips)
dubskanker: posts the ante 30
Mars dlhe: posts the ante 30
Cherep1993: posts the ante 30
passat1g: posts the ante 30
cedricdb95: posts the ante 30
Raddow: posts the ante 30
NeCTar222: posts the ante 30
elketefuka: posts the ante 30
TENSAI POKER: posts the ante 30
NeCTar222: posts small blind 125
elketefuka: posts big blind 250
*** HOLE CARDS ***
Dealt to elketefuka [6s 8d]
TENSAI POKER: folds
dubskanker: raises 400 to 650
Mars dlhe: calls 650
Cherep1993: folds
passat1g: folds
cedricdb95: folds
Raddow: folds
NeCTar222: calls 525
elketefuka: folds
*** FLOP *** [5c 4s 3d]
NeCTar222: checks
dubskanker: bets 2000
Mars dlhe: folds
NeCTar222: calls 2000
*** TURN *** [5c 4s 3d] [Kc]
NeCTar222: checks
dubskanker: bets 601 and is all-in
NeCTar222: calls 601
*** RIVER *** [5c 4s 3d Kc] [9h]
*** SHOW DOWN ***
NeCTar222: shows [Ac 7d] (high card Ace)
dubskanker: shows [Ah Ad] (a pair of Aces)
dubskanker collected 7672 from pot
*** SUMMARY ***
Total pot 7672 | Rake 0
Board [5c 4s 3d Kc 9h]
Seat 1: dubskanker showed [Ah Ad] and won (7672) with a pair of Aces
Seat 2: Mars dlhe folded on the Flop
Seat 3: Cherep1993 folded before Flop (didn't bet)
Seat 4: passat1g folded before Flop (didn't bet)
Seat 5: cedricdb95 folded before Flop (didn't bet)
Seat 6: Raddow (button) folded before Flop (didn't bet)
Seat 7: NeCTar222 (small blind) showed [Ac 7d] and lost with high card Ace
Seat 8: elketefuka (big blind) folded before Flop
Seat 9: TENSAI POKER folded before Flop (didn't bet)


*********** # 81 **************
PokerStars Hand #214026605886: Tournament #2896837020, $0.98+$0.12 USD Hold'em No Limit - Level X (125/250) - 2020/05/17 10:55:03 ET
Table '2896837020 67' 9-max Seat #7 is the button
Seat 1: dubskanker (7672 in chips)
Seat 2: Mars dlhe (8010 in chips)
Seat 3: Cherep1993 (16938 in chips)
Seat 4: passat1g (3085 in chips)
Seat 5: cedricdb95 (8800 in chips)
Seat 6: Raddow (6833 in chips)
Seat 7: NeCTar222 (19963 in chips)
Seat 8: elketefuka (26873 in chips)
Seat 9: TENSAI POKER (7104 in chips)
dubskanker: posts the ante 30
Mars dlhe: posts the ante 30
Cherep1993: posts the ante 30
passat1g: posts the ante 30
cedricdb95: posts the ante 30
Raddow: posts the ante 30
NeCTar222: posts the ante 30
elketefuka: posts the ante 30
TENSAI POKER: posts the ante 30
elketefuka: posts small blind 125
TENSAI POKER: posts big blind 250
*** HOLE CARDS ***
Dealt to elketefuka [6s 8d]
dubskanker: folds
Mars dlhe: folds
Cherep1993: raises 750 to 1000
passat1g: raises 2055 to 3055 and is all-in
cedricdb95: folds
Raddow: folds
NeCTar222: folds
elketefuka: folds
TENSAI POKER: folds
Cherep1993: calls 2055
*** FLOP *** [Ts Ks 2h]
*** TURN *** [Ts Ks 2h] [5d]
*** RIVER *** [Ts Ks 2h 5d] [5c]
*** SHOW DOWN ***
Cherep1993: shows [Jd Js] (two pair, Jacks and Fives)
passat1g: shows [7s 7h] (two pair, Sevens and Fives)
Cherep1993 collected 6755 from pot
passat1g finished the tournament in 1624th place
*** SUMMARY ***
Total pot 6755 | Rake 0
Board [Ts Ks 2h 5d 5c]
Seat 1: dubskanker folded before Flop (didn't bet)
Seat 2: Mars dlhe folded before Flop (didn't bet)
Seat 3: Cherep1993 showed [Jd Js] and won (6755) with two pair, Jacks and Fives
Seat 4: passat1g showed [7s 7h] and lost with two pair, Sevens and Fives
Seat 5: cedricdb95 folded before Flop (didn't bet)
Seat 6: Raddow folded before Flop (didn't bet)
Seat 7: NeCTar222 (button) folded before Flop (didn't bet)
Seat 8: elketefuka (small blind) folded before Flop
Seat 9: TENSAI POKER (big blind) folded before Flop


*********** # 82 **************
PokerStars Hand #214026886236: Tournament #2896837020, $0.98+$0.12 USD Hold'em No Limit - Level X (125/250) - 2020/05/17 11:02:23 ET
Table '2896837020 67' 9-max Seat #8 is the button
Seat 1: dubskanker (7642 in chips)
Seat 2: Mars dlhe (7980 in chips)
Seat 3: Cherep1993 (20608 in chips)
Seat 4: turpauuno2 (3000 in chips)
Seat 5: cedricdb95 (8770 in chips)
Seat 6: Raddow (6803 in chips)
Seat 7: NeCTar222 (19933 in chips)
Seat 8: elketefuka (26718 in chips)
Seat 9: Molly_Angel (3000 in chips) out of hand (moved from another table into small blind)
Molly_Angel will be allowed to play after the button
dubskanker: posts the ante 30
Mars dlhe: posts the ante 30
Cherep1993: posts the ante 30
turpauuno2: posts the ante 30
cedricdb95: posts the ante 30
Raddow: posts the ante 30
NeCTar222: posts the ante 30
elketefuka: posts the ante 30
dubskanker: posts small blind 125
Mars dlhe: posts big blind 250
*** HOLE CARDS ***
Dealt to elketefuka [4s 8s]
Cherep1993: folds
turpauuno2: folds
cedricdb95: folds
Raddow: folds
NeCTar222: folds
elketefuka: raises 500 to 750
dubskanker: folds
Mars dlhe: folds
Uncalled bet (500) returned to elketefuka
elketefuka collected 865 from pot
elketefuka: doesn't show hand
*** SUMMARY ***
Total pot 865 | Rake 0
Seat 1: dubskanker (small blind) folded before Flop
Seat 2: Mars dlhe (big blind) folded before Flop
Seat 3: Cherep1993 folded before Flop (didn't bet)
Seat 4: turpauuno2 folded before Flop (didn't bet)
Seat 5: cedricdb95 folded before Flop (didn't bet)
Seat 6: Raddow folded before Flop (didn't bet)
Seat 7: NeCTar222 folded before Flop (didn't bet)
Seat 8: elketefuka (button) collected (865)


*********** # 83 **************
PokerStars Hand #214026906160: Tournament #2896837020, $0.98+$0.12 USD Hold'em No Limit - Level X (125/250) - 2020/05/17 11:02:48 ET
Table '2896837020 67' 9-max Seat #1 is the button
Seat 1: dubskanker (7487 in chips)
Seat 2: Mars dlhe (7700 in chips)
Seat 3: Cherep1993 (20578 in chips)
Seat 4: turpauuno2 (2970 in chips)
Seat 5: cedricdb95 (8740 in chips)
Seat 6: Raddow (6773 in chips)
Seat 7: NeCTar222 (19903 in chips)
Seat 8: elketefuka (27303 in chips)
Seat 9: Molly_Angel (3000 in chips)
dubskanker: posts the ante 30
Mars dlhe: posts the ante 30
Cherep1993: posts the ante 30
turpauuno2: posts the ante 30
cedricdb95: posts the ante 30
Raddow: posts the ante 30
NeCTar222: posts the ante 30
elketefuka: posts the ante 30
Molly_Angel: posts the ante 30
Mars dlhe: posts small blind 125
Cherep1993: posts big blind 250
*** HOLE CARDS ***
Dealt to elketefuka [Qd 7c]
turpauuno2: calls 250
cedricdb95: folds
Raddow: folds
NeCTar222: folds
elketefuka: folds
Molly_Angel: folds
dubskanker: raises 250 to 500
Mars dlhe: folds
Cherep1993: folds
turpauuno2: calls 250
*** FLOP *** [8s Js 6h]
turpauuno2: checks
dubskanker: bets 900
turpauuno2: folds
Uncalled bet (900) returned to dubskanker
dubskanker collected 1645 from pot
dubskanker: doesn't show hand
*** SUMMARY ***
Total pot 1645 | Rake 0
Board [8s Js 6h]
Seat 1: dubskanker (button) collected (1645)
Seat 2: Mars dlhe (small blind) folded before Flop
Seat 3: Cherep1993 (big blind) folded before Flop
Seat 4: turpauuno2 folded on the Flop
Seat 5: cedricdb95 folded before Flop (didn't bet)
Seat 6: Raddow folded before Flop (didn't bet)
Seat 7: NeCTar222 folded before Flop (didn't bet)
Seat 8: elketefuka folded before Flop (didn't bet)
Seat 9: Molly_Angel folded before Flop (didn't bet)


*********** # 84 **************
PokerStars Hand #214026951570: Tournament #2896837020, $0.98+$0.12 USD Hold'em No Limit - Level X (125/250) - 2020/05/17 11:03:42 ET
Table '2896837020 67' 9-max Seat #2 is the button
Seat 1: dubskanker (8602 in chips)
Seat 2: Mars dlhe (7545 in chips)
Seat 3: Cherep1993 (20298 in chips)
Seat 4: turpauuno2 (2440 in chips)
Seat 5: cedricdb95 (8710 in chips)
Seat 6: Raddow (6743 in chips)
Seat 7: NeCTar222 (19873 in chips)
Seat 8: elketefuka (27273 in chips)
Seat 9: Molly_Angel (2970 in chips)
dubskanker: posts the ante 30
Mars dlhe: posts the ante 30
Cherep1993: posts the ante 30
turpauuno2: posts the ante 30
cedricdb95: posts the ante 30
Raddow: posts the ante 30
NeCTar222: posts the ante 30
elketefuka: posts the ante 30
Molly_Angel: posts the ante 30
Cherep1993: posts small blind 125
turpauuno2: posts big blind 250
*** HOLE CARDS ***
Dealt to elketefuka [Td 8h]
cedricdb95 has timed out
cedricdb95: folds
cedricdb95 is sitting out
Raddow: folds
NeCTar222: calls 250
elketefuka: folds
Molly_Angel: calls 250
dubskanker: folds
Mars dlhe: raises 500 to 750
Cherep1993: folds
turpauuno2: folds
NeCTar222: calls 500
Molly_Angel: calls 500
*** FLOP *** [6h 4c 6d]
NeCTar222: checks
Molly_Angel: checks
Mars dlhe: bets 1448
NeCTar222: folds
Molly_Angel: folds
Uncalled bet (1448) returned to Mars dlhe
Mars dlhe collected 2895 from pot
Mars dlhe: doesn't show hand
*** SUMMARY ***
Total pot 2895 | Rake 0
Board [6h 4c 6d]
Seat 1: dubskanker folded before Flop (didn't bet)
Seat 2: Mars dlhe (button) collected (2895)
Seat 3: Cherep1993 (small blind) folded before Flop
Seat 4: turpauuno2 (big blind) folded before Flop
Seat 5: cedricdb95 folded before Flop (didn't bet)
Seat 6: Raddow folded before Flop (didn't bet)
Seat 7: NeCTar222 folded on the Flop
Seat 8: elketefuka folded before Flop (didn't bet)
Seat 9: Molly_Angel folded on the Flop


*********** # 85 **************
PokerStars Hand #214026993359: Tournament #2896837020, $0.98+$0.12 USD Hold'em No Limit - Level X (125/250) - 2020/05/17 11:04:33 ET
Table '2896837020 67' 9-max Seat #3 is the button
Seat 1: dubskanker (8572 in chips)
Seat 2: Mars dlhe (9660 in chips)
Seat 3: Cherep1993 (20143 in chips)
Seat 4: turpauuno2 (2160 in chips)
Seat 5: cedricdb95 (8680 in chips) is sitting out
Seat 6: Raddow (6713 in chips)
Seat 7: NeCTar222 (19093 in chips)
Seat 8: elketefuka (27243 in chips)
Seat 9: Molly_Angel (2190 in chips)
dubskanker: posts the ante 30
Mars dlhe: posts the ante 30
Cherep1993: posts the ante 30
turpauuno2: posts the ante 30
cedricdb95: posts the ante 30
Raddow: posts the ante 30
NeCTar222: posts the ante 30
elketefuka: posts the ante 30
Molly_Angel: posts the ante 30
turpauuno2: posts small blind 125
cedricdb95: posts big blind 250
*** HOLE CARDS ***
Dealt to elketefuka [Js 7d]
Raddow: folds
NeCTar222: folds
elketefuka: folds
Molly_Angel: folds
dubskanker: folds
cedricdb95 has returned
Mars dlhe: calls 250
Cherep1993: folds
turpauuno2: raises 1880 to 2130 and is all-in
cedricdb95 has timed out
cedricdb95: folds
cedricdb95 is sitting out
cedricdb95 has returned
Mars dlhe: folds
Uncalled bet (1880) returned to turpauuno2
turpauuno2 collected 1020 from pot
turpauuno2: doesn't show hand
*** SUMMARY ***
Total pot 1020 | Rake 0
Seat 1: dubskanker folded before Flop (didn't bet)
Seat 2: Mars dlhe folded before Flop
Seat 3: Cherep1993 (button) folded before Flop (didn't bet)
Seat 4: turpauuno2 (small blind) collected (1020)
Seat 5: cedricdb95 (big blind) folded before Flop
Seat 6: Raddow folded before Flop (didn't bet)
Seat 7: NeCTar222 folded before Flop (didn't bet)
Seat 8: elketefuka folded before Flop (didn't bet)
Seat 9: Molly_Angel folded before Flop (didn't bet)


*********** # 86 **************
PokerStars Hand #214027047719: Tournament #2896837020, $0.98+$0.12 USD Hold'em No Limit - Level X (125/250) - 2020/05/17 11:05:36 ET
Table '2896837020 67' 9-max Seat #4 is the button
Seat 1: dubskanker (8542 in chips)
Seat 2: Mars dlhe (9380 in chips)
Seat 3: Cherep1993 (20113 in chips)
Seat 4: turpauuno2 (2900 in chips)
Seat 5: cedricdb95 (8400 in chips)
Seat 6: Raddow (6683 in chips)
Seat 7: NeCTar222 (19063 in chips)
Seat 8: elketefuka (27213 in chips)
Seat 9: Molly_Angel (2160 in chips)
dubskanker: posts the ante 30
Mars dlhe: posts the ante 30
Cherep1993: posts the ante 30
turpauuno2: posts the ante 30
cedricdb95: posts the ante 30
Raddow: posts the ante 30
NeCTar222: posts the ante 30
elketefuka: posts the ante 30
Molly_Angel: posts the ante 30
cedricdb95: posts small blind 125
Raddow: posts big blind 250
*** HOLE CARDS ***
Dealt to elketefuka [2c Kh]
NeCTar222: folds
elketefuka: folds
Molly_Angel: folds
dubskanker: folds
Mars dlhe: calls 250
Cherep1993: raises 500 to 750
turpauuno2: folds
cedricdb95: folds
Raddow: folds
Mars dlhe: calls 500
*** FLOP *** [As Qc 8c]
Mars dlhe: checks
Cherep1993: bets 708
Mars dlhe: calls 708
*** TURN *** [As Qc 8c] [Ad]
Mars dlhe: checks
Cherep1993: checks
*** RIVER *** [As Qc 8c Ad] [Jd]
Mars dlhe: bets 500
Cherep1993: raises 5750 to 6250
Mars dlhe: folds
Uncalled bet (5750) returned to Cherep1993
Cherep1993 collected 4561 from pot
Cherep1993: doesn't show hand
*** SUMMARY ***
Total pot 4561 | Rake 0
Board [As Qc 8c Ad Jd]
Seat 1: dubskanker folded before Flop (didn't bet)
Seat 2: Mars dlhe folded on the River
Seat 3: Cherep1993 collected (4561)
Seat 4: turpauuno2 (button) folded before Flop (didn't bet)
Seat 5: cedricdb95 (small blind) folded before Flop
Seat 6: Raddow (big blind) folded before Flop
Seat 7: NeCTar222 folded before Flop (didn't bet)
Seat 8: elketefuka folded before Flop (didn't bet)
Seat 9: Molly_Angel folded before Flop (didn't bet)


*********** # 87 **************
PokerStars Hand #214027100797: Tournament #2896837020, $0.98+$0.12 USD Hold'em No Limit - Level X (125/250) - 2020/05/17 11:06:37 ET
Table '2896837020 67' 9-max Seat #5 is the button
Seat 1: dubskanker (8512 in chips)
Seat 2: Mars dlhe (7392 in chips)
Seat 3: Cherep1993 (22686 in chips)
Seat 4: turpauuno2 (2870 in chips)
Seat 5: cedricdb95 (8245 in chips)
Seat 6: Raddow (6403 in chips)
Seat 7: NeCTar222 (19033 in chips)
Seat 8: elketefuka (27183 in chips)
Seat 9: Molly_Angel (2130 in chips)
dubskanker: posts the ante 30
Mars dlhe: posts the ante 30
Cherep1993: posts the ante 30
turpauuno2: posts the ante 30
cedricdb95: posts the ante 30
Raddow: posts the ante 30
NeCTar222: posts the ante 30
elketefuka: posts the ante 30
Molly_Angel: posts the ante 30
Raddow: posts small blind 125
NeCTar222: posts big blind 250
*** HOLE CARDS ***
Dealt to elketefuka [8h Kd]
elketefuka: calls 250
Molly_Angel: calls 250
dubskanker: folds
Mars dlhe: calls 250
Cherep1993: folds
turpauuno2: folds
cedricdb95: calls 250
Raddow: folds
NeCTar222: checks
*** FLOP *** [Js 8s 4h]
NeCTar222: checks
elketefuka: bets 750
Molly_Angel: folds
Mars dlhe: calls 750
cedricdb95: folds
NeCTar222: folds
*** TURN *** [Js 8s 4h] [6s]
elketefuka: checks
Mars dlhe: bets 1573
elketefuka: folds
Uncalled bet (1573) returned to Mars dlhe
Mars dlhe collected 3145 from pot
Mars dlhe: doesn't show hand
*** SUMMARY ***
Total pot 3145 | Rake 0
Board [Js 8s 4h 6s]
Seat 1: dubskanker folded before Flop (didn't bet)
Seat 2: Mars dlhe collected (3145)
Seat 3: Cherep1993 folded before Flop (didn't bet)
Seat 4: turpauuno2 folded before Flop (didn't bet)
Seat 5: cedricdb95 (button) folded on the Flop
Seat 6: Raddow (small blind) folded before Flop
Seat 7: NeCTar222 (big blind) folded on the Flop
Seat 8: elketefuka folded on the Turn
Seat 9: Molly_Angel folded on the Flop


*********** # 88 **************
PokerStars Hand #214027169088: Tournament #2896837020, $0.98+$0.12 USD Hold'em No Limit - Level X (125/250) - 2020/05/17 11:07:55 ET
Table '2896837020 67' 9-max Seat #6 is the button
Seat 1: dubskanker (8482 in chips)
Seat 2: Mars dlhe (9507 in chips)
Seat 3: Cherep1993 (22656 in chips)
Seat 4: turpauuno2 (2840 in chips)
Seat 5: cedricdb95 (7965 in chips)
Seat 6: Raddow (6248 in chips)
Seat 7: NeCTar222 (18753 in chips)
Seat 8: elketefuka (26153 in chips)
Seat 9: Molly_Angel (1850 in chips)
dubskanker: posts the ante 30
Mars dlhe: posts the ante 30
Cherep1993: posts the ante 30
turpauuno2: posts the ante 30
cedricdb95: posts the ante 30
Raddow: posts the ante 30
NeCTar222: posts the ante 30
elketefuka: posts the ante 30
Molly_Angel: posts the ante 30
NeCTar222: posts small blind 125
elketefuka: posts big blind 250
*** HOLE CARDS ***
Dealt to elketefuka [5d Jh]
Molly_Angel: folds
dubskanker: folds
Mars dlhe: raises 500 to 750
Cherep1993: folds
turpauuno2: folds
cedricdb95: calls 750
Raddow: folds
NeCTar222: calls 625
elketefuka: folds
*** FLOP *** [Qs 9s Ac]
NeCTar222: checks
Mars dlhe: bets 750
cedricdb95: calls 750
NeCTar222: calls 750
*** TURN *** [Qs 9s Ac] [8d]
NeCTar222: checks
Mars dlhe: checks
cedricdb95: checks
*** RIVER *** [Qs 9s Ac 8d] [4s]
NeCTar222: bets 3750
Mars dlhe: folds
cedricdb95: folds
Uncalled bet (3750) returned to NeCTar222
NeCTar222 collected 5020 from pot
*** SUMMARY ***
Total pot 5020 | Rake 0
Board [Qs 9s Ac 8d 4s]
Seat 1: dubskanker folded before Flop (didn't bet)
Seat 2: Mars dlhe folded on the River
Seat 3: Cherep1993 folded before Flop (didn't bet)
Seat 4: turpauuno2 folded before Flop (didn't bet)
Seat 5: cedricdb95 folded on the River
Seat 6: Raddow (button) folded before Flop (didn't bet)
Seat 7: NeCTar222 (small blind) collected (5020)
Seat 8: elketefuka (big blind) folded before Flop
Seat 9: Molly_Angel folded before Flop (didn't bet)


*********** # 89 **************
PokerStars Hand #214027238731: Tournament #2896837020, $0.98+$0.12 USD Hold'em No Limit - Level XI (150/300) - 2020/05/17 11:09:15 ET
Table '2896837020 67' 9-max Seat #7 is the button
Seat 1: dubskanker (8452 in chips)
Seat 2: Mars dlhe (7977 in chips)
Seat 3: Cherep1993 (22626 in chips)
Seat 4: turpauuno2 (2810 in chips)
Seat 5: cedricdb95 (6435 in chips)
Seat 6: Raddow (6218 in chips)
Seat 7: NeCTar222 (22243 in chips)
Seat 8: elketefuka (25873 in chips)
Seat 9: Molly_Angel (1820 in chips)
dubskanker: posts the ante 40
Mars dlhe: posts the ante 40
Cherep1993: posts the ante 40
turpauuno2: posts the ante 40
cedricdb95: posts the ante 40
Raddow: posts the ante 40
NeCTar222: posts the ante 40
elketefuka: posts the ante 40
Molly_Angel: posts the ante 40
elketefuka: posts small blind 150
Molly_Angel: posts big blind 300
*** HOLE CARDS ***
Dealt to elketefuka [8h Js]
dubskanker: folds
Mars dlhe: calls 300
Cherep1993: folds
turpauuno2: folds
cedricdb95: calls 300
Raddow: raises 750 to 1050
NeCTar222: folds
elketefuka: folds
Molly_Angel: folds
Mars dlhe: calls 750
cedricdb95: calls 750
*** FLOP *** [7h 9c 9h]
Mars dlhe: checks
cedricdb95: bets 900
Raddow: folds
Mars dlhe: raises 5987 to 6887 and is all-in
cedricdb95: calls 4445 and is all-in
Uncalled bet (1542) returned to Mars dlhe
*** TURN *** [7h 9c 9h] [3h]
*** RIVER *** [7h 9c 9h 3h] [2c]
*** SHOW DOWN ***
Mars dlhe: shows [Ad 6s] (a pair of Nines)
cedricdb95: shows [Th 9d] (three of a kind, Nines)
cedricdb95 collected 14650 from pot
*** SUMMARY ***
Total pot 14650 | Rake 0
Board [7h 9c 9h 3h 2c]
Seat 1: dubskanker folded before Flop (didn't bet)
Seat 2: Mars dlhe showed [Ad 6s] and lost with a pair of Nines
Seat 3: Cherep1993 folded before Flop (didn't bet)
Seat 4: turpauuno2 folded before Flop (didn't bet)
Seat 5: cedricdb95 showed [Th 9d] and won (14650) with three of a kind, Nines
Seat 6: Raddow folded on the Flop
Seat 7: NeCTar222 (button) folded before Flop (didn't bet)
Seat 8: elketefuka (small blind) folded before Flop
Seat 9: Molly_Angel (big blind) folded before Flop


*********** # 90 **************
PokerStars Hand #214027294879: Tournament #2896837020, $0.98+$0.12 USD Hold'em No Limit - Level XI (150/300) - 2020/05/17 11:10:19 ET
Table '2896837020 67' 9-max Seat #8 is the button
Seat 1: dubskanker (8412 in chips)
Seat 2: Mars dlhe (1542 in chips)
Seat 3: Cherep1993 (22586 in chips)
Seat 4: turpauuno2 (2770 in chips)
Seat 5: cedricdb95 (14650 in chips)
Seat 6: Raddow (5128 in chips)
Seat 7: NeCTar222 (22203 in chips)
Seat 8: elketefuka (25683 in chips)
Seat 9: Molly_Angel (1480 in chips)
dubskanker: posts the ante 40
Mars dlhe: posts the ante 40
Cherep1993: posts the ante 40
turpauuno2: posts the ante 40
cedricdb95: posts the ante 40
Raddow: posts the ante 40
NeCTar222: posts the ante 40
elketefuka: posts the ante 40
Molly_Angel: posts the ante 40
Molly_Angel: posts small blind 150
dubskanker: posts big blind 300
*** HOLE CARDS ***
Dealt to elketefuka [3h 9s]
Mars dlhe: raises 1202 to 1502 and is all-in
Cherep1993: folds
turpauuno2: folds
cedricdb95: folds
Raddow: folds
NeCTar222: calls 1502
elketefuka: folds
Molly_Angel: folds
dubskanker: folds
*** FLOP *** [Ks 8h 3d]
*** TURN *** [Ks 8h 3d] [Ad]
*** RIVER *** [Ks 8h 3d Ad] [5d]
*** SHOW DOWN ***
Mars dlhe: shows [4d 4s] (a pair of Fours)
NeCTar222: shows [Ah Td] (a pair of Aces)
NeCTar222 collected 3814 from pot
Mars dlhe finished the tournament in 1297th place
*** SUMMARY ***
Total pot 3814 | Rake 0
Board [Ks 8h 3d Ad 5d]
Seat 1: dubskanker (big blind) folded before Flop
Seat 2: Mars dlhe showed [4d 4s] and lost with a pair of Fours
Seat 3: Cherep1993 folded before Flop (didn't bet)
Seat 4: turpauuno2 folded before Flop (didn't bet)
Seat 5: cedricdb95 folded before Flop (didn't bet)
Seat 6: Raddow folded before Flop (didn't bet)
Seat 7: NeCTar222 showed [Ah Td] and won (3814) with a pair of Aces
Seat 8: elketefuka (button) folded before Flop (didn't bet)
Seat 9: Molly_Angel (small blind) folded before Flop


*********** # 91 **************
PokerStars Hand #214027375408: Tournament #2896837020, $0.98+$0.12 USD Hold'em No Limit - Level XI (150/300) - 2020/05/17 11:11:51 ET
Table '2896837020 44' 9-max Seat #3 is the button
Seat 2: elketefuka (25643 in chips)
Seat 3: Snow Bars RU (7459 in chips)
Seat 4: Newi74 (6323 in chips)
Seat 5: Selzer5 (15431 in chips)
Seat 6: JulianaOliveira (5427 in chips)
Seat 7: juni0rZ (2631 in chips)
Seat 8: JFJQ (7547 in chips)
Seat 9: stoper92 (12561 in chips)
elketefuka: posts the ante 40
Snow Bars RU: posts the ante 40
Newi74: posts the ante 40
Selzer5: posts the ante 40
JulianaOliveira: posts the ante 40
juni0rZ: posts the ante 40
JFJQ: posts the ante 40
stoper92: posts the ante 40
Newi74: posts small blind 150
Selzer5: posts big blind 300
*** HOLE CARDS ***
Dealt to elketefuka [4s Qs]
JulianaOliveira: folds
juni0rZ: folds
JFJQ: folds
stoper92: folds
elketefuka: raises 300 to 600
Snow Bars RU: folds
Newi74: folds
Selzer5: folds
Uncalled bet (300) returned to elketefuka
elketefuka collected 1070 from pot
elketefuka: doesn't show hand
*** SUMMARY ***
Total pot 1070 | Rake 0
Seat 2: elketefuka collected (1070)
Seat 3: Snow Bars RU (button) folded before Flop (didn't bet)
Seat 4: Newi74 (small blind) folded before Flop
Seat 5: Selzer5 (big blind) folded before Flop
Seat 6: JulianaOliveira folded before Flop (didn't bet)
Seat 7: juni0rZ folded before Flop (didn't bet)
Seat 8: JFJQ folded before Flop (didn't bet)
Seat 9: stoper92 folded before Flop (didn't bet)


*********** # 92 **************
PokerStars Hand #214027393458: Tournament #2896837020, $0.98+$0.12 USD Hold'em No Limit - Level XI (150/300) - 2020/05/17 11:12:11 ET
Table '2896837020 44' 9-max Seat #4 is the button
Seat 1: Max 121rus (14171 in chips)
Seat 2: elketefuka (26373 in chips)
Seat 3: Snow Bars RU (7419 in chips)
Seat 4: Newi74 (6133 in chips)
Seat 5: Selzer5 (15091 in chips)
Seat 6: JulianaOliveira (5387 in chips)
Seat 7: juni0rZ (2591 in chips)
Seat 8: JFJQ (7507 in chips)
Seat 9: stoper92 (12521 in chips)
Max 121rus: posts the ante 40
elketefuka: posts the ante 40
Snow Bars RU: posts the ante 40
Newi74: posts the ante 40
Selzer5: posts the ante 40
JulianaOliveira: posts the ante 40
juni0rZ: posts the ante 40
JFJQ: posts the ante 40
stoper92: posts the ante 40
Selzer5: posts small blind 150
JulianaOliveira: posts big blind 300
*** HOLE CARDS ***
Dealt to elketefuka [Tc 5s]
juni0rZ: folds
JFJQ: folds
stoper92: folds
Max 121rus: folds
elketefuka: folds
Snow Bars RU: raises 600 to 900
Newi74: folds
Selzer5: calls 750
JulianaOliveira: folds
*** FLOP *** [Th Kc 8c]
Selzer5: checks
Snow Bars RU: bets 1230
Selzer5: folds
Uncalled bet (1230) returned to Snow Bars RU
Snow Bars RU collected 2460 from pot
Snow Bars RU: doesn't show hand
*** SUMMARY ***
Total pot 2460 | Rake 0
Board [Th Kc 8c]
Seat 1: Max 121rus folded before Flop (didn't bet)
Seat 2: elketefuka folded before Flop (didn't bet)
Seat 3: Snow Bars RU collected (2460)
Seat 4: Newi74 (button) folded before Flop (didn't bet)
Seat 5: Selzer5 (small blind) folded on the Flop
Seat 6: JulianaOliveira (big blind) folded before Flop
Seat 7: juni0rZ folded before Flop (didn't bet)
Seat 8: JFJQ folded before Flop (didn't bet)
Seat 9: stoper92 folded before Flop (didn't bet)


*********** # 93 **************
PokerStars Hand #214027436730: Tournament #2896837020, $0.98+$0.12 USD Hold'em No Limit - Level XI (150/300) - 2020/05/17 11:13:00 ET
Table '2896837020 207' 9-max Seat #4 is the button
Seat 1: Hafiz294 (6583 in chips)
Seat 2: Arm Fulito (6210 in chips)
Seat 3: 0636363 (6564 in chips)
Seat 4: Douskenov (10634 in chips)
Seat 5: praskachev (17810 in chips)
Seat 6: eeazy_boy (12142 in chips)
Seat 7: moredeadfish (5289 in chips)
Seat 8: nandofido (17232 in chips)
Seat 9: elketefuka (26333 in chips)
Hafiz294: posts the ante 40
Arm Fulito: posts the ante 40
0636363: posts the ante 40
Douskenov: posts the ante 40
praskachev: posts the ante 40
eeazy_boy: posts the ante 40
moredeadfish: posts the ante 40
nandofido: posts the ante 40
elketefuka: posts the ante 40
praskachev: posts small blind 150
eeazy_boy: posts big blind 300
*** HOLE CARDS ***
Dealt to elketefuka [4h Th]
moredeadfish: folds
nandofido: calls 300
Arm Fulito is disconnected
elketefuka: calls 300
Hafiz294: folds
Arm Fulito has timed out while disconnected
Arm Fulito: folds
Arm Fulito is sitting out
0636363: calls 300
Douskenov: folds
praskachev: raises 1800 to 2100
eeazy_boy: folds
nandofido: folds
elketefuka: folds
0636363: calls 1800
*** FLOP *** [4s Tc 8c]
praskachev: bets 2730
0636363: folds
Uncalled bet (2730) returned to praskachev
praskachev collected 5460 from pot
praskachev: doesn't show hand
*** SUMMARY ***
Total pot 5460 | Rake 0
Board [4s Tc 8c]
Seat 1: Hafiz294 folded before Flop (didn't bet)
Seat 2: Arm Fulito folded before Flop (didn't bet)
Seat 3: 0636363 folded on the Flop
Seat 4: Douskenov (button) folded before Flop (didn't bet)
Seat 5: praskachev (small blind) collected (5460)
Seat 6: eeazy_boy (big blind) folded before Flop
Seat 7: moredeadfish folded before Flop (didn't bet)
Seat 8: nandofido folded before Flop
Seat 9: elketefuka folded before Flop


*********** # 94 **************
PokerStars Hand #214027492497: Tournament #2896837020, $0.98+$0.12 USD Hold'em No Limit - Level XI (150/300) - 2020/05/17 11:14:03 ET
Table '2896837020 207' 9-max Seat #5 is the button
Seat 1: Hafiz294 (6543 in chips)
Seat 2: Arm Fulito (6170 in chips) is sitting out
Seat 3: 0636363 (4424 in chips)
Seat 4: Douskenov (10594 in chips)
Seat 5: praskachev (21130 in chips)
Seat 6: eeazy_boy (11802 in chips)
Seat 7: moredeadfish (5249 in chips)
Seat 8: nandofido (16892 in chips)
Seat 9: elketefuka (25993 in chips)
Hafiz294: posts the ante 40
Arm Fulito: posts the ante 40
0636363: posts the ante 40
Douskenov: posts the ante 40
praskachev: posts the ante 40
eeazy_boy: posts the ante 40
moredeadfish: posts the ante 40
nandofido: posts the ante 40
elketefuka: posts the ante 40
eeazy_boy: posts small blind 150
moredeadfish: posts big blind 300
*** HOLE CARDS ***
Dealt to elketefuka [Qh Jc]
nandofido: folds
elketefuka: calls 300
Hafiz294: folds
Arm Fulito: folds
0636363: folds
Douskenov: calls 300
praskachev: folds
eeazy_boy: folds
moredeadfish: checks
*** FLOP *** [3c 5d 5s]
moredeadfish: checks
elketefuka: bets 600
Douskenov: calls 600
moredeadfish: calls 600
*** TURN *** [3c 5d 5s] [8c]
moredeadfish: checks
elketefuka: checks
Douskenov: checks
*** RIVER *** [3c 5d 5s 8c] [Qs]
moredeadfish: checks
elketefuka: bets 1500
Douskenov: calls 1500
moredeadfish: folds
*** SHOW DOWN ***
elketefuka: shows [Qh Jc] (two pair, Queens and Fives)
Douskenov: mucks hand
elketefuka collected 6210 from pot
*** SUMMARY ***
Total pot 6210 | Rake 0
Board [3c 5d 5s 8c Qs]
Seat 1: Hafiz294 folded before Flop (didn't bet)
Seat 2: Arm Fulito folded before Flop (didn't bet)
Seat 3: 0636363 folded before Flop (didn't bet)
Seat 4: Douskenov mucked [Ts Qc]
Seat 5: praskachev (button) folded before Flop (didn't bet)
Seat 6: eeazy_boy (small blind) folded before Flop
Seat 7: moredeadfish (big blind) folded on the River
Seat 8: nandofido folded before Flop (didn't bet)
Seat 9: elketefuka showed [Qh Jc] and won (6210) with two pair, Queens and Fives


*********** # 95 **************
PokerStars Hand #214027582749: Tournament #2896837020, $0.98+$0.12 USD Hold'em No Limit - Level XI (150/300) - 2020/05/17 11:15:41 ET
Table '2896837020 207' 9-max Seat #6 is the button
Seat 1: Hafiz294 (6503 in chips)
Seat 2: Arm Fulito (6130 in chips) is sitting out
Seat 3: 0636363 (4384 in chips)
Seat 4: Douskenov (8154 in chips)
Seat 5: praskachev (21090 in chips)
Seat 6: eeazy_boy (11612 in chips)
Seat 7: moredeadfish (4309 in chips)
Seat 8: nandofido (16852 in chips)
Seat 9: elketefuka (29763 in chips)
Hafiz294: posts the ante 40
Arm Fulito: posts the ante 40
0636363: posts the ante 40
Douskenov: posts the ante 40
praskachev: posts the ante 40
eeazy_boy: posts the ante 40
moredeadfish: posts the ante 40
nandofido: posts the ante 40
elketefuka: posts the ante 40
moredeadfish: posts small blind 150
nandofido: posts big blind 300
*** HOLE CARDS ***
Dealt to elketefuka [8d 5h]
elketefuka: folds
Hafiz294: calls 300
Arm Fulito: folds
0636363: folds
Douskenov: folds
praskachev: folds
eeazy_boy: raises 11272 to 11572 and is all-in
Arm Fulito has returned
moredeadfish: folds
nandofido: folds
Hafiz294: calls 6163 and is all-in
Uncalled bet (5109) returned to eeazy_boy
*** FLOP *** [Qd 6c 5c]
*** TURN *** [Qd 6c 5c] [3h]
*** RIVER *** [Qd 6c 5c 3h] [9h]
*** SHOW DOWN ***
Hafiz294: shows [Qs 9d] (two pair, Queens and Nines)
eeazy_boy: shows [Ah Kd] (high card Ace)
Hafiz294 collected 13736 from pot
*** SUMMARY ***
Total pot 13736 | Rake 0
Board [Qd 6c 5c 3h 9h]
Seat 1: Hafiz294 showed [Qs 9d] and won (13736) with two pair, Queens and Nines
Seat 2: Arm Fulito folded before Flop (didn't bet)
Seat 3: 0636363 folded before Flop (didn't bet)
Seat 4: Douskenov folded before Flop (didn't bet)
Seat 5: praskachev folded before Flop (didn't bet)
Seat 6: eeazy_boy (button) showed [Ah Kd] and lost with high card Ace
Seat 7: moredeadfish (small blind) folded before Flop
Seat 8: nandofido (big blind) folded before Flop
Seat 9: elketefuka folded before Flop (didn't bet)


*********** # 96 **************
PokerStars Hand #214027619687: Tournament #2896837020, $0.98+$0.12 USD Hold'em No Limit - Level XI (150/300) - 2020/05/17 11:16:22 ET
Table '2896837020 207' 9-max Seat #7 is the button
Seat 1: Hafiz294 (13736 in chips)
Seat 2: Arm Fulito (6090 in chips)
Seat 3: 0636363 (4344 in chips)
Seat 4: Douskenov (8114 in chips)
Seat 5: praskachev (21050 in chips)
Seat 6: eeazy_boy (5109 in chips)
Seat 7: moredeadfish (4119 in chips)
Seat 8: nandofido (16512 in chips)
Seat 9: elketefuka (29723 in chips)
Hafiz294: posts the ante 40
Arm Fulito: posts the ante 40
0636363: posts the ante 40
Douskenov: posts the ante 40
praskachev: posts the ante 40
eeazy_boy: posts the ante 40
moredeadfish: posts the ante 40
nandofido: posts the ante 40
elketefuka: posts the ante 40
nandofido: posts small blind 150
elketefuka: posts big blind 300
*** HOLE CARDS ***
Dealt to elketefuka [4h 2h]
Hafiz294: calls 300
Arm Fulito: folds
0636363: folds
Douskenov has timed out
Douskenov: folds
Douskenov is sitting out
praskachev: folds
eeazy_boy: folds
moredeadfish: folds
nandofido: calls 150
elketefuka: checks
*** FLOP *** [3s 9h Qs]
nandofido: checks
elketefuka: checks
Hafiz294: bets 300
nandofido: folds
elketefuka: calls 300
*** TURN *** [3s 9h Qs] [4s]
elketefuka: checks
Hafiz294: checks
*** RIVER *** [3s 9h Qs 4s] [6h]
elketefuka: bets 900
Hafiz294: calls 900
*** SHOW DOWN ***
elketefuka: shows [4h 2h] (a pair of Fours)
Hafiz294: shows [9d 7d] (a pair of Nines)
Hafiz294 collected 3660 from pot
*** SUMMARY ***
Total pot 3660 | Rake 0
Board [3s 9h Qs 4s 6h]
Seat 1: Hafiz294 showed [9d 7d] and won (3660) with a pair of Nines
Seat 2: Arm Fulito folded before Flop (didn't bet)
Seat 3: 0636363 folded before Flop (didn't bet)
Seat 4: Douskenov folded before Flop (didn't bet)
Seat 5: praskachev folded before Flop (didn't bet)
Seat 6: eeazy_boy folded before Flop (didn't bet)
Seat 7: moredeadfish (button) folded before Flop (didn't bet)
Seat 8: nandofido (small blind) folded on the Flop
Seat 9: elketefuka (big blind) showed [4h 2h] and lost with a pair of Fours


*********** # 97 **************
PokerStars Hand #214027714607: Tournament #2896837020, $0.98+$0.12 USD Hold'em No Limit - Level XI (150/300) - 2020/05/17 11:18:09 ET
Table '2896837020 207' 9-max Seat #8 is the button
Seat 1: Hafiz294 (15856 in chips)
Seat 2: Arm Fulito (6050 in chips)
Seat 3: 0636363 (4304 in chips)
Seat 4: Douskenov (8074 in chips) is sitting out
Seat 5: praskachev (21010 in chips)
Seat 6: eeazy_boy (5069 in chips)
Seat 7: moredeadfish (4079 in chips)
Seat 8: nandofido (16172 in chips)
Seat 9: elketefuka (28183 in chips)
Hafiz294: posts the ante 40
Arm Fulito: posts the ante 40
0636363: posts the ante 40
Douskenov: posts the ante 40
praskachev: posts the ante 40
eeazy_boy: posts the ante 40
moredeadfish: posts the ante 40
nandofido: posts the ante 40
elketefuka: posts the ante 40
elketefuka: posts small blind 150
Hafiz294: posts big blind 300
*** HOLE CARDS ***
Dealt to elketefuka [Js 4d]
Arm Fulito: folds
0636363: folds
Douskenov: folds
praskachev: folds
eeazy_boy: folds
Douskenov has returned
moredeadfish: raises 3739 to 4039 and is all-in
nandofido: folds
elketefuka: folds
Hafiz294 has timed out
Hafiz294: folds
Hafiz294 is sitting out
Uncalled bet (3739) returned to moredeadfish
moredeadfish collected 1110 from pot
moredeadfish: doesn't show hand
*** SUMMARY ***
Total pot 1110 | Rake 0
Seat 1: Hafiz294 (big blind) folded before Flop
Seat 2: Arm Fulito folded before Flop (didn't bet)
Seat 3: 0636363 folded before Flop (didn't bet)
Seat 4: Douskenov folded before Flop (didn't bet)
Seat 5: praskachev folded before Flop (didn't bet)
Seat 6: eeazy_boy folded before Flop (didn't bet)
Seat 7: moredeadfish collected (1110)
Seat 8: nandofido (button) folded before Flop (didn't bet)
Seat 9: elketefuka (small blind) folded before Flop


*********** # 98 **************
PokerStars Hand #214027752995: Tournament #2896837020, $0.98+$0.12 USD Hold'em No Limit - Level XI (150/300) - 2020/05/17 11:18:52 ET
Table '2896837020 207' 9-max Seat #9 is the button
Seat 1: Hafiz294 (15516 in chips) is sitting out
Seat 2: Arm Fulito (6010 in chips)
Seat 3: 0636363 (4264 in chips)
Seat 4: Douskenov (8034 in chips)
Seat 5: praskachev (20970 in chips)
Seat 6: eeazy_boy (5029 in chips)
Seat 7: moredeadfish (4849 in chips)
Seat 8: nandofido (16132 in chips)
Seat 9: elketefuka (27993 in chips)
Hafiz294: posts the ante 40
Arm Fulito: posts the ante 40
0636363: posts the ante 40
Douskenov: posts the ante 40
praskachev: posts the ante 40
eeazy_boy: posts the ante 40
moredeadfish: posts the ante 40
nandofido: posts the ante 40
elketefuka: posts the ante 40
Hafiz294: posts small blind 150
Arm Fulito: posts big blind 300
*** HOLE CARDS ***
Dealt to elketefuka [5d 4h]
0636363: calls 300
Hafiz294 has returned
Douskenov: raises 1410 to 1710
praskachev: folds
eeazy_boy: folds
moredeadfish: folds
nandofido: folds
elketefuka: folds
Hafiz294: folds
Arm Fulito: calls 1410
0636363: folds
*** FLOP *** [Kd Jh Td]
Arm Fulito: checks
Douskenov: bets 2100
Arm Fulito: calls 2100
*** TURN *** [Kd Jh Td] [7d]
Arm Fulito: bets 2160 and is all-in
Douskenov: calls 2160
*** RIVER *** [Kd Jh Td 7d] [Kh]
*** SHOW DOWN ***
Arm Fulito: shows [Ac 7s] (two pair, Kings and Sevens)
Douskenov: shows [Tc Ts] (a full house, Tens full of Kings)
Douskenov collected 12750 from pot
Arm Fulito finished the tournament in 1063rd place
*** SUMMARY ***
Total pot 12750 | Rake 0
Board [Kd Jh Td 7d Kh]
Seat 1: Hafiz294 (small blind) folded before Flop
Seat 2: Arm Fulito (big blind) showed [Ac 7s] and lost with two pair, Kings and Sevens
Seat 3: 0636363 folded before Flop
Seat 4: Douskenov showed [Tc Ts] and won (12750) with a full house, Tens full of Kings
Seat 5: praskachev folded before Flop (didn't bet)
Seat 6: eeazy_boy folded before Flop (didn't bet)
Seat 7: moredeadfish folded before Flop (didn't bet)
Seat 8: nandofido folded before Flop (didn't bet)
Seat 9: elketefuka (button) folded before Flop (didn't bet)


*********** # 99 **************
PokerStars Hand #214027806674: Tournament #2896837020, $0.98+$0.12 USD Hold'em No Limit - Level XII (200/400) - 2020/05/17 11:19:52 ET
Table '2896837020 159' 9-max Seat #7 is the button
Seat 1: knedy10 (19222 in chips)
Seat 2: 1the_specialone (5108 in chips)
Seat 3: ALIENS100 (4780 in chips)
Seat 4: @ferrazraf (5850 in chips)
Seat 5: elketefuka (27953 in chips)
Seat 6: Rdmulder (17578 in chips)
Seat 7: 13LábúKárlosz (7146 in chips)
Seat 8: shipittosav7 (9454 in chips)
Seat 9: Petey Pop (3173 in chips)
knedy10: posts the ante 50
1the_specialone: posts the ante 50
ALIENS100: posts the ante 50
@ferrazraf: posts the ante 50
elketefuka: posts the ante 50
Rdmulder: posts the ante 50
13LábúKárlosz: posts the ante 50
shipittosav7: posts the ante 50
Petey Pop: posts the ante 50
shipittosav7: posts small blind 200
Petey Pop: posts big blind 400
*** HOLE CARDS ***
Dealt to elketefuka [9c Kc]
knedy10: folds
1the_specialone: folds
ALIENS100: calls 400
@ferrazraf: folds
elketefuka: calls 400
Rdmulder: folds
13LábúKárlosz: folds
shipittosav7: folds
Petey Pop: checks
*** FLOP *** [9h 8s 6c]
Petey Pop: checks
ALIENS100: bets 400
elketefuka: calls 400
Petey Pop: calls 400
*** TURN *** [9h 8s 6c] [3h]
Petey Pop: checks
ALIENS100: checks
elketefuka: bets 1600
Petey Pop: folds
ALIENS100: raises 2330 to 3930 and is all-in
elketefuka: calls 2330
*** RIVER *** [9h 8s 6c 3h] [2h]
*** SHOW DOWN ***
ALIENS100: shows [Th Jh] (a flush, Jack high)
elketefuka: shows [9c Kc] (a pair of Nines)
ALIENS100 collected 10910 from pot
*** SUMMARY ***
Total pot 10910 | Rake 0
Board [9h 8s 6c 3h 2h]
Seat 1: knedy10 folded before Flop (didn't bet)
Seat 2: 1the_specialone folded before Flop (didn't bet)
Seat 3: ALIENS100 showed [Th Jh] and won (10910) with a flush, Jack high
Seat 4: @ferrazraf folded before Flop (didn't bet)
Seat 5: elketefuka showed [9c Kc] and lost with a pair of Nines
Seat 6: Rdmulder folded before Flop (didn't bet)
Seat 7: 13LábúKárlosz (button) folded before Flop (didn't bet)
Seat 8: shipittosav7 (small blind) folded before Flop
Seat 9: Petey Pop (big blind) folded on the Turn


*********** # 100 **************
PokerStars Hand #214027885182: Tournament #2896837020, $0.98+$0.12 USD Hold'em No Limit - Level XII (200/400) - 2020/05/17 11:21:21 ET
Table '2896837020 159' 9-max Seat #8 is the button
Seat 1: knedy10 (19172 in chips)
Seat 2: 1the_specialone (5058 in chips)
Seat 3: ALIENS100 (10910 in chips)
Seat 4: @ferrazraf (5800 in chips)
Seat 5: elketefuka (23173 in chips)
Seat 6: Rdmulder (17528 in chips)
Seat 7: 13LábúKárlosz (7096 in chips)
Seat 8: shipittosav7 (9204 in chips)
Seat 9: Petey Pop (2323 in chips)
knedy10: posts the ante 50
1the_specialone: posts the ante 50
ALIENS100: posts the ante 50
@ferrazraf: posts the ante 50
elketefuka: posts the ante 50
Rdmulder: posts the ante 50
13LábúKárlosz: posts the ante 50
shipittosav7: posts the ante 50
Petey Pop: posts the ante 50
Petey Pop: posts small blind 200
knedy10: posts big blind 400
*** HOLE CARDS ***
Dealt to elketefuka [Ac As]
1the_specialone: folds
ALIENS100: folds
@ferrazraf: folds
elketefuka: raises 800 to 1200
Rdmulder: folds
13LábúKárlosz: folds
shipittosav7 has timed out
shipittosav7: folds
shipittosav7 is sitting out
Petey Pop: raises 1073 to 2273 and is all-in
knedy10: folds
elketefuka: calls 1073
*** FLOP *** [3c 5h 9h]
*** TURN *** [3c 5h 9h] [Th]
shipittosav7 has returned
*** RIVER *** [3c 5h 9h Th] [4h]
*** SHOW DOWN ***
Petey Pop: shows [Td Tc] (three of a kind, Tens)
elketefuka: shows [Ac As] (a pair of Aces)
Petey Pop collected 5396 from pot
*** SUMMARY ***
Total pot 5396 | Rake 0
Board [3c 5h 9h Th 4h]
Seat 1: knedy10 (big blind) folded before Flop
Seat 2: 1the_specialone folded before Flop (didn't bet)
Seat 3: ALIENS100 folded before Flop (didn't bet)
Seat 4: @ferrazraf folded before Flop (didn't bet)
Seat 5: elketefuka showed [Ac As] and lost with a pair of Aces
Seat 6: Rdmulder folded before Flop (didn't bet)
Seat 7: 13LábúKárlosz folded before Flop (didn't bet)
Seat 8: shipittosav7 (button) folded before Flop (didn't bet)
Seat 9: Petey Pop (small blind) showed [Td Tc] and won (5396) with three of a kind, Tens


*********** # 101 **************
PokerStars Hand #214027930117: Tournament #2896837020, $0.98+$0.12 USD Hold'em No Limit - Level XII (200/400) - 2020/05/17 11:22:11 ET
Table '2896837020 159' 9-max Seat #9 is the button
Seat 1: knedy10 (18722 in chips)
Seat 2: 1the_specialone (5008 in chips)
Seat 3: ALIENS100 (10860 in chips)
Seat 4: @ferrazraf (5750 in chips)
Seat 5: elketefuka (20850 in chips)
Seat 6: Rdmulder (17478 in chips)
Seat 7: 13LábúKárlosz (7046 in chips)
Seat 8: shipittosav7 (9154 in chips)
Seat 9: Petey Pop (5396 in chips)
knedy10: posts the ante 50
1the_specialone: posts the ante 50
ALIENS100: posts the ante 50
@ferrazraf: posts the ante 50
elketefuka: posts the ante 50
Rdmulder: posts the ante 50
13LábúKárlosz: posts the ante 50
shipittosav7: posts the ante 50
Petey Pop: posts the ante 50
knedy10: posts small blind 200
1the_specialone: posts big blind 400
*** HOLE CARDS ***
Dealt to elketefuka [9d Jc]
ALIENS100: folds
@ferrazraf: raises 5300 to 5700 and is all-in
elketefuka: folds
Rdmulder: folds
13LábúKárlosz: folds
shipittosav7 has timed out
shipittosav7: folds
shipittosav7 is sitting out
shipittosav7 has returned
Petey Pop: folds
knedy10: folds
1the_specialone: folds
Uncalled bet (5300) returned to @ferrazraf
@ferrazraf collected 1450 from pot
@ferrazraf: doesn't show hand
*** SUMMARY ***
Total pot 1450 | Rake 0
Seat 1: knedy10 (small blind) folded before Flop
Seat 2: 1the_specialone (big blind) folded before Flop
Seat 3: ALIENS100 folded before Flop (didn't bet)
Seat 4: @ferrazraf collected (1450)
Seat 5: elketefuka folded before Flop (didn't bet)
Seat 6: Rdmulder folded before Flop (didn't bet)
Seat 7: 13LábúKárlosz folded before Flop (didn't bet)
Seat 8: shipittosav7 folded before Flop (didn't bet)
Seat 9: Petey Pop (button) folded before Flop (didn't bet)


*********** # 102 **************
PokerStars Hand #214027977429: Tournament #2896837020, $0.98+$0.12 USD Hold'em No Limit - Level XII (200/400) - 2020/05/17 11:23:04 ET
Table '2896837020 159' 9-max Seat #1 is the button
Seat 1: knedy10 (18472 in chips)
Seat 2: 1the_specialone (4558 in chips)
Seat 3: ALIENS100 (10810 in chips)
Seat 4: @ferrazraf (6750 in chips)
Seat 5: elketefuka (20800 in chips)
Seat 6: Rdmulder (17428 in chips)
Seat 7: 13LábúKárlosz (6996 in chips)
Seat 8: shipittosav7 (9104 in chips)
Seat 9: Petey Pop (5346 in chips)
knedy10: posts the ante 50
1the_specialone: posts the ante 50
ALIENS100: posts the ante 50
@ferrazraf: posts the ante 50
elketefuka: posts the ante 50
Rdmulder: posts the ante 50
13LábúKárlosz: posts the ante 50
shipittosav7: posts the ante 50
Petey Pop: posts the ante 50
1the_specialone: posts small blind 200
ALIENS100: posts big blind 400
*** HOLE CARDS ***
Dealt to elketefuka [8c Qd]
@ferrazraf: raises 520 to 920
elketefuka: folds
Rdmulder: folds
13LábúKárlosz: folds
shipittosav7: raises 8134 to 9054 and is all-in
Petey Pop: folds
knedy10: folds
1the_specialone: folds
ALIENS100: folds
@ferrazraf: folds
Uncalled bet (8134) returned to shipittosav7
shipittosav7 collected 2890 from pot
shipittosav7: doesn't show hand
*** SUMMARY ***
Total pot 2890 | Rake 0
Seat 1: knedy10 (button) folded before Flop (didn't bet)
Seat 2: 1the_specialone (small blind) folded before Flop
Seat 3: ALIENS100 (big blind) folded before Flop
Seat 4: @ferrazraf folded before Flop
Seat 5: elketefuka folded before Flop (didn't bet)
Seat 6: Rdmulder folded before Flop (didn't bet)
Seat 7: 13LábúKárlosz folded before Flop (didn't bet)
Seat 8: shipittosav7 collected (2890)
Seat 9: Petey Pop folded before Flop (didn't bet)


*********** # 103 **************
PokerStars Hand #214028012702: Tournament #2896837020, $0.98+$0.12 USD Hold'em No Limit - Level XII (200/400) - 2020/05/17 11:23:41 ET
Table '2896837020 159' 9-max Seat #2 is the button
Seat 1: knedy10 (18422 in chips)
Seat 2: 1the_specialone (4308 in chips)
Seat 3: ALIENS100 (10360 in chips)
Seat 4: @ferrazraf (5780 in chips)
Seat 5: elketefuka (20750 in chips)
Seat 6: Rdmulder (17378 in chips)
Seat 7: 13LábúKárlosz (6946 in chips)
Seat 8: shipittosav7 (11024 in chips)
Seat 9: Petey Pop (5296 in chips)
knedy10: posts the ante 50
1the_specialone: posts the ante 50
ALIENS100: posts the ante 50
@ferrazraf: posts the ante 50
elketefuka: posts the ante 50
Rdmulder: posts the ante 50
13LábúKárlosz: posts the ante 50
shipittosav7: posts the ante 50
Petey Pop: posts the ante 50
ALIENS100: posts small blind 200
@ferrazraf: posts big blind 400
*** HOLE CARDS ***
Dealt to elketefuka [Ah 8s]
elketefuka: calls 400
Rdmulder: folds
13LábúKárlosz: raises 6496 to 6896 and is all-in
shipittosav7 has timed out
shipittosav7: folds
shipittosav7 is sitting out
shipittosav7 has returned
Petey Pop: folds
knedy10: folds
1the_specialone: folds
ALIENS100: folds
@ferrazraf: folds
elketefuka: folds
Uncalled bet (6496) returned to 13LábúKárlosz
13LábúKárlosz collected 1850 from pot
13LábúKárlosz: doesn't show hand
*** SUMMARY ***
Total pot 1850 | Rake 0
Seat 1: knedy10 folded before Flop (didn't bet)
Seat 2: 1the_specialone (button) folded before Flop (didn't bet)
Seat 3: ALIENS100 (small blind) folded before Flop
Seat 4: @ferrazraf (big blind) folded before Flop
Seat 5: elketefuka folded before Flop
Seat 6: Rdmulder folded before Flop (didn't bet)
Seat 7: 13LábúKárlosz collected (1850)
Seat 8: shipittosav7 folded before Flop (didn't bet)
Seat 9: Petey Pop folded before Flop (didn't bet)


*********** # 104 **************
PokerStars Hand #214028054302: Tournament #2896837020, $0.98+$0.12 USD Hold'em No Limit - Level XII (200/400) - 2020/05/17 11:24:27 ET
Table '2896837020 159' 9-max Seat #3 is the button
Seat 1: knedy10 (18372 in chips)
Seat 2: 1the_specialone (4258 in chips)
Seat 3: ALIENS100 (10110 in chips)
Seat 4: @ferrazraf (5330 in chips)
Seat 5: elketefuka (20300 in chips)
Seat 6: Rdmulder (17328 in chips)
Seat 7: 13LábúKárlosz (8346 in chips)
Seat 8: shipittosav7 (10974 in chips)
Seat 9: Petey Pop (5246 in chips)
knedy10: posts the ante 50
1the_specialone: posts the ante 50
ALIENS100: posts the ante 50
@ferrazraf: posts the ante 50
elketefuka: posts the ante 50
Rdmulder: posts the ante 50
13LábúKárlosz: posts the ante 50
shipittosav7: posts the ante 50
Petey Pop: posts the ante 50
@ferrazraf: posts small blind 200
elketefuka: posts big blind 400
*** HOLE CARDS ***
Dealt to elketefuka [Th 9c]
Rdmulder: calls 400
13LábúKárlosz: folds
shipittosav7 has timed out
shipittosav7: folds
shipittosav7 is sitting out
shipittosav7 has returned
Petey Pop: folds
knedy10: folds
1the_specialone: folds
ALIENS100: folds
@ferrazraf: folds
elketefuka: checks
*** FLOP *** [3h 3d 5c]
elketefuka: checks
Rdmulder: bets 725
elketefuka: calls 725
*** TURN *** [3h 3d 5c] [Kc]
elketefuka: checks
Rdmulder: bets 870
elketefuka: folds
Uncalled bet (870) returned to Rdmulder
Rdmulder collected 2900 from pot
Rdmulder: doesn't show hand
*** SUMMARY ***
Total pot 2900 | Rake 0
Board [3h 3d 5c Kc]
Seat 1: knedy10 folded before Flop (didn't bet)
Seat 2: 1the_specialone folded before Flop (didn't bet)
Seat 3: ALIENS100 (button) folded before Flop (didn't bet)
Seat 4: @ferrazraf (small blind) folded before Flop
Seat 5: elketefuka (big blind) folded on the Turn
Seat 6: Rdmulder collected (2900)
Seat 7: 13LábúKárlosz folded before Flop (didn't bet)
Seat 8: shipittosav7 folded before Flop (didn't bet)
Seat 9: Petey Pop folded before Flop (didn't bet)


*********** # 105 **************
PokerStars Hand #214028121504: Tournament #2896837020, $0.98+$0.12 USD Hold'em No Limit - Level XII (200/400) - 2020/05/17 11:25:43 ET
Table '2896837020 159' 9-max Seat #4 is the button
Seat 1: knedy10 (18322 in chips)
Seat 2: 1the_specialone (4208 in chips)
Seat 3: ALIENS100 (10060 in chips)
Seat 4: @ferrazraf (5080 in chips)
Seat 5: elketefuka (19125 in chips)
Seat 6: Rdmulder (19053 in chips)
Seat 7: 13LábúKárlosz (8296 in chips)
Seat 8: shipittosav7 (10924 in chips)
Seat 9: Petey Pop (5196 in chips)
knedy10: posts the ante 50
1the_specialone: posts the ante 50
ALIENS100: posts the ante 50
@ferrazraf: posts the ante 50
elketefuka: posts the ante 50
Rdmulder: posts the ante 50
13LábúKárlosz: posts the ante 50
shipittosav7: posts the ante 50
Petey Pop: posts the ante 50
elketefuka: posts small blind 200
Rdmulder: posts big blind 400
*** HOLE CARDS ***
Dealt to elketefuka [3d Kd]
13LábúKárlosz: folds
shipittosav7 has timed out
shipittosav7: folds
shipittosav7 is sitting out
shipittosav7 has returned
Petey Pop: folds
knedy10: folds
1the_specialone: folds
ALIENS100: calls 400
@ferrazraf is disconnected
@ferrazraf has timed out while disconnected
@ferrazraf: folds
@ferrazraf is sitting out
elketefuka: calls 200
Rdmulder: checks
*** FLOP *** [6c 3s 4d]
elketefuka: checks
Rdmulder: checks
ALIENS100: bets 400
elketefuka: calls 400
Rdmulder: folds
*** TURN *** [6c 3s 4d] [7d]
elketefuka: checks
ALIENS100: checks
*** RIVER *** [6c 3s 4d 7d] [Qh]
elketefuka: bets 1200
ALIENS100: calls 1200
*** SHOW DOWN ***
elketefuka: shows [3d Kd] (a pair of Threes)
ALIENS100: mucks hand
elketefuka collected 4850 from pot
*** SUMMARY ***
Total pot 4850 | Rake 0
Board [6c 3s 4d 7d Qh]
Seat 1: knedy10 folded before Flop (didn't bet)
Seat 2: 1the_specialone folded before Flop (didn't bet)
Seat 3: ALIENS100 mucked [2h Ad]
Seat 4: @ferrazraf (button) folded before Flop (didn't bet)
Seat 5: elketefuka (small blind) showed [3d Kd] and won (4850) with a pair of Threes
Seat 6: Rdmulder (big blind) folded on the Flop
Seat 7: 13LábúKárlosz folded before Flop (didn't bet)
Seat 8: shipittosav7 folded before Flop (didn't bet)
Seat 9: Petey Pop folded before Flop (didn't bet)


*********** # 106 **************
PokerStars Hand #214028192483: Tournament #2896837020, $0.98+$0.12 USD Hold'em No Limit - Level XII (200/400) - 2020/05/17 11:27:03 ET
Table '2896837020 159' 9-max Seat #5 is the button
Seat 1: knedy10 (18272 in chips)
Seat 2: 1the_specialone (4158 in chips)
Seat 3: ALIENS100 (8010 in chips)
Seat 4: @ferrazraf (5030 in chips) is sitting out
Seat 5: elketefuka (21925 in chips)
Seat 6: Rdmulder (18603 in chips)
Seat 7: 13LábúKárlosz (8246 in chips)
Seat 8: shipittosav7 (10874 in chips)
Seat 9: Petey Pop (5146 in chips)
knedy10: posts the ante 50
1the_specialone: posts the ante 50
ALIENS100: posts the ante 50
@ferrazraf: posts the ante 50
elketefuka: posts the ante 50
Rdmulder: posts the ante 50
13LábúKárlosz: posts the ante 50
shipittosav7: posts the ante 50
Petey Pop: posts the ante 50
Rdmulder: posts small blind 200
13LábúKárlosz: posts big blind 400
*** HOLE CARDS ***
Dealt to elketefuka [Kc 6d]
shipittosav7: folds
Petey Pop: folds
knedy10: folds
1the_specialone: folds
ALIENS100: raises 400 to 800
@ferrazraf: folds
elketefuka: calls 800
Rdmulder: calls 600
13LábúKárlosz: calls 400
*** FLOP *** [9s 3c 2d]
Rdmulder: checks
13LábúKárlosz: checks
ALIENS100: checks
elketefuka is disconnected
elketefuka is connected
elketefuka: checks
*** TURN *** [9s 3c 2d] [Js]
Rdmulder: checks
13LábúKárlosz: bets 1800
ALIENS100: folds
elketefuka: folds
Rdmulder: folds
Uncalled bet (1800) returned to 13LábúKárlosz
13LábúKárlosz collected 3650 from pot
13LábúKárlosz: doesn't show hand
*** SUMMARY ***
Total pot 3650 | Rake 0
Board [9s 3c 2d Js]
Seat 1: knedy10 folded before Flop (didn't bet)
Seat 2: 1the_specialone folded before Flop (didn't bet)
Seat 3: ALIENS100 folded on the Turn
Seat 4: @ferrazraf folded before Flop (didn't bet)
Seat 5: elketefuka (button) folded on the Turn
Seat 6: Rdmulder (small blind) folded on the Turn
Seat 7: 13LábúKárlosz (big blind) collected (3650)
Seat 8: shipittosav7 folded before Flop (didn't bet)
Seat 9: Petey Pop folded before Flop (didn't bet)


*********** # 107 **************
PokerStars Hand #214028263534: Tournament #2896837020, $0.98+$0.12 USD Hold'em No Limit - Level XII (200/400) - 2020/05/17 11:28:22 ET
Table '2896837020 159' 9-max Seat #6 is the button
Seat 1: knedy10 (18222 in chips)
Seat 2: 1the_specialone (4108 in chips)
Seat 3: ALIENS100 (7160 in chips)
Seat 4: @ferrazraf (4980 in chips) is sitting out
Seat 5: elketefuka (21075 in chips)
Seat 6: Rdmulder (17753 in chips)
Seat 7: 13LábúKárlosz (11046 in chips)
Seat 8: shipittosav7 (10824 in chips)
Seat 9: Petey Pop (5096 in chips)
knedy10: posts the ante 50
1the_specialone: posts the ante 50
ALIENS100: posts the ante 50
@ferrazraf: posts the ante 50
elketefuka: posts the ante 50
Rdmulder: posts the ante 50
13LábúKárlosz: posts the ante 50
shipittosav7: posts the ante 50
Petey Pop: posts the ante 50
13LábúKárlosz: posts small blind 200
shipittosav7: posts big blind 400
*** HOLE CARDS ***
Dealt to elketefuka [Qc 3d]
Petey Pop has timed out
Petey Pop: folds
Petey Pop is sitting out
Petey Pop has returned
knedy10: folds
1the_specialone: folds
ALIENS100: folds
@ferrazraf: folds
elketefuka: folds
Rdmulder: folds
13LábúKárlosz: folds
Uncalled bet (200) returned to shipittosav7
shipittosav7 collected 850 from pot
shipittosav7: doesn't show hand
*** SUMMARY ***
Total pot 850 | Rake 0
Seat 1: knedy10 folded before Flop (didn't bet)
Seat 2: 1the_specialone folded before Flop (didn't bet)
Seat 3: ALIENS100 folded before Flop (didn't bet)
Seat 4: @ferrazraf folded before Flop (didn't bet)
Seat 5: elketefuka folded before Flop (didn't bet)
Seat 6: Rdmulder (button) folded before Flop (didn't bet)
Seat 7: 13LábúKárlosz (small blind) folded before Flop
Seat 8: shipittosav7 (big blind) collected (850)
Seat 9: Petey Pop folded before Flop (didn't bet)


*********** # 108 **************
PokerStars Hand #214028309205: Tournament #2896837020, $0.98+$0.12 USD Hold'em No Limit - Level XIII (250/500) - 2020/05/17 11:29:05 ET
Table '2896837020 159' 9-max Seat #7 is the button
Seat 1: knedy10 (18172 in chips)
Seat 2: 1the_specialone (4058 in chips)
Seat 3: ALIENS100 (7110 in chips)
Seat 4: @ferrazraf (4930 in chips) is sitting out
Seat 5: elketefuka (21025 in chips)
Seat 6: Rdmulder (17703 in chips)
Seat 7: 13LábúKárlosz (10796 in chips)
Seat 8: shipittosav7 (11424 in chips)
Seat 9: Petey Pop (5046 in chips)
knedy10: posts the ante 60
1the_specialone: posts the ante 60
ALIENS100: posts the ante 60
@ferrazraf: posts the ante 60
elketefuka: posts the ante 60
Rdmulder: posts the ante 60
13LábúKárlosz: posts the ante 60
shipittosav7: posts the ante 60
Petey Pop: posts the ante 60
shipittosav7: posts small blind 250
Petey Pop: posts big blind 500
*** HOLE CARDS ***
Dealt to elketefuka [5h 7s]
knedy10: folds
@ferrazraf has returned
1the_specialone is disconnected
1the_specialone has timed out
1the_specialone: folds
1the_specialone is sitting out
ALIENS100: folds
1the_specialone has returned
@ferrazraf: folds
elketefuka: folds
Rdmulder: folds
13LábúKárlosz: raises 1000 to 1500
shipittosav7: folds
Petey Pop: folds
Uncalled bet (1000) returned to 13LábúKárlosz
13LábúKárlosz collected 1790 from pot
13LábúKárlosz: doesn't show hand
*** SUMMARY ***
Total pot 1790 | Rake 0
Seat 1: knedy10 folded before Flop (didn't bet)
Seat 2: 1the_specialone folded before Flop (didn't bet)
Seat 3: ALIENS100 folded before Flop (didn't bet)
Seat 4: @ferrazraf folded before Flop (didn't bet)
Seat 5: elketefuka folded before Flop (didn't bet)
Seat 6: Rdmulder folded before Flop (didn't bet)
Seat 7: 13LábúKárlosz (button) collected (1790)
Seat 8: shipittosav7 (small blind) folded before Flop
Seat 9: Petey Pop (big blind) folded before Flop


*********** # 109 **************
PokerStars Hand #214028422126: Tournament #2896837020, $0.98+$0.12 USD Hold'em No Limit - Level XIII (250/500) - 2020/05/17 11:31:10 ET
Table '2896837020 159' 9-max Seat #8 is the button
Seat 1: knedy10 (18112 in chips)
Seat 2: 1the_specialone (3998 in chips)
Seat 3: ALIENS100 (7050 in chips)
Seat 4: @ferrazraf (4870 in chips)
Seat 5: elketefuka (20965 in chips)
Seat 6: Rdmulder (17643 in chips)
Seat 7: 13LábúKárlosz (12026 in chips)
Seat 8: shipittosav7 (11114 in chips)
Seat 9: Petey Pop (4486 in chips)
knedy10: posts the ante 60
1the_specialone: posts the ante 60
ALIENS100: posts the ante 60
@ferrazraf: posts the ante 60
elketefuka: posts the ante 60
Rdmulder: posts the ante 60
13LábúKárlosz: posts the ante 60
shipittosav7: posts the ante 60
Petey Pop: posts the ante 60
Petey Pop: posts small blind 250
knedy10: posts big blind 500
*** HOLE CARDS ***
Dealt to elketefuka [3s 8h]
1the_specialone: folds
ALIENS100: folds
@ferrazraf: folds
elketefuka: folds
Rdmulder: folds
13LábúKárlosz: folds
shipittosav7: folds
Petey Pop: folds
Uncalled bet (250) returned to knedy10
knedy10 collected 1040 from pot
knedy10: doesn't show hand
*** SUMMARY ***
Total pot 1040 | Rake 0
Seat 1: knedy10 (big blind) collected (1040)
Seat 2: 1the_specialone folded before Flop (didn't bet)
Seat 3: ALIENS100 folded before Flop (didn't bet)
Seat 4: @ferrazraf folded before Flop (didn't bet)
Seat 5: elketefuka folded before Flop (didn't bet)
Seat 6: Rdmulder folded before Flop (didn't bet)
Seat 7: 13LábúKárlosz folded before Flop (didn't bet)
Seat 8: shipittosav7 (button) folded before Flop (didn't bet)
Seat 9: Petey Pop (small blind) folded before Flop


*********** # 110 **************
PokerStars Hand #214028448261: Tournament #2896837020, $0.98+$0.12 USD Hold'em No Limit - Level XIII (250/500) - 2020/05/17 11:31:39 ET
Table '2896837020 159' 9-max Seat #9 is the button
Seat 1: knedy10 (18842 in chips)
Seat 2: 1the_specialone (3938 in chips)
Seat 3: ALIENS100 (6990 in chips)
Seat 4: @ferrazraf (4810 in chips)
Seat 5: elketefuka (20905 in chips)
Seat 6: Rdmulder (17583 in chips)
Seat 7: 13LábúKárlosz (11966 in chips)
Seat 8: shipittosav7 (11054 in chips)
Seat 9: Petey Pop (4176 in chips)
knedy10: posts the ante 60
1the_specialone: posts the ante 60
ALIENS100: posts the ante 60
@ferrazraf: posts the ante 60
elketefuka: posts the ante 60
Rdmulder: posts the ante 60
13LábúKárlosz: posts the ante 60
shipittosav7: posts the ante 60
Petey Pop: posts the ante 60
knedy10: posts small blind 250
1the_specialone: posts big blind 500
*** HOLE CARDS ***
Dealt to elketefuka [7c 6s]
ALIENS100: folds
@ferrazraf: folds
elketefuka: folds
Rdmulder: folds
13LábúKárlosz: folds
shipittosav7: raises 715 to 1215
Petey Pop: folds
knedy10: folds
1the_specialone: folds
Uncalled bet (715) returned to shipittosav7
shipittosav7 collected 1790 from pot
shipittosav7: doesn't show hand
*** SUMMARY ***
Total pot 1790 | Rake 0
Seat 1: knedy10 (small blind) folded before Flop
Seat 2: 1the_specialone (big blind) folded before Flop
Seat 3: ALIENS100 folded before Flop (didn't bet)
Seat 4: @ferrazraf folded before Flop (didn't bet)
Seat 5: elketefuka folded before Flop (didn't bet)
Seat 6: Rdmulder folded before Flop (didn't bet)
Seat 7: 13LábúKárlosz folded before Flop (didn't bet)
Seat 8: shipittosav7 collected (1790)
Seat 9: Petey Pop (button) folded before Flop (didn't bet)


*********** # 111 **************
PokerStars Hand #214028488351: Tournament #2896837020, $0.98+$0.12 USD Hold'em No Limit - Level XIII (250/500) - 2020/05/17 11:32:23 ET
Table '2896837020 159' 9-max Seat #1 is the button
Seat 1: knedy10 (18532 in chips)
Seat 2: 1the_specialone (3378 in chips)
Seat 3: ALIENS100 (6930 in chips)
Seat 4: @ferrazraf (4750 in chips)
Seat 5: elketefuka (20845 in chips)
Seat 6: Rdmulder (17523 in chips)
Seat 7: 13LábúKárlosz (11906 in chips)
Seat 8: shipittosav7 (12284 in chips)
Seat 9: Petey Pop (4116 in chips)
knedy10: posts the ante 60
1the_specialone: posts the ante 60
ALIENS100: posts the ante 60
@ferrazraf: posts the ante 60
elketefuka: posts the ante 60
Rdmulder: posts the ante 60
13LábúKárlosz: posts the ante 60
shipittosav7: posts the ante 60
Petey Pop: posts the ante 60
1the_specialone: posts small blind 250
ALIENS100: posts big blind 500
*** HOLE CARDS ***
Dealt to elketefuka [4d Qd]
@ferrazraf has timed out
@ferrazraf: folds
@ferrazraf is sitting out
elketefuka: folds
Rdmulder: folds
13LábúKárlosz: folds
shipittosav7: raises 715 to 1215
Petey Pop: folds
knedy10: folds
1the_specialone: folds
ALIENS100: folds
Uncalled bet (715) returned to shipittosav7
shipittosav7 collected 1790 from pot
shipittosav7: doesn't show hand
*** SUMMARY ***
Total pot 1790 | Rake 0
Seat 1: knedy10 (button) folded before Flop (didn't bet)
Seat 2: 1the_specialone (small blind) folded before Flop
Seat 3: ALIENS100 (big blind) folded before Flop
Seat 4: @ferrazraf folded before Flop (didn't bet)
Seat 5: elketefuka folded before Flop (didn't bet)
Seat 6: Rdmulder folded before Flop (didn't bet)
Seat 7: 13LábúKárlosz folded before Flop (didn't bet)
Seat 8: shipittosav7 collected (1790)
Seat 9: Petey Pop folded before Flop (didn't bet)


*********** # 112 **************
PokerStars Hand #214028527923: Tournament #2896837020, $0.98+$0.12 USD Hold'em No Limit - Level XIII (250/500) - 2020/05/17 11:33:07 ET
Table '2896837020 159' 9-max Seat #2 is the button
Seat 1: knedy10 (18472 in chips)
Seat 2: 1the_specialone (3068 in chips)
Seat 3: ALIENS100 (6370 in chips)
Seat 4: @ferrazraf (4690 in chips) is sitting out
Seat 5: elketefuka (20785 in chips)
Seat 6: Rdmulder (17463 in chips)
Seat 7: 13LábúKárlosz (11846 in chips)
Seat 8: shipittosav7 (13514 in chips)
Seat 9: Petey Pop (4056 in chips)
knedy10: posts the ante 60
1the_specialone: posts the ante 60
ALIENS100: posts the ante 60
@ferrazraf: posts the ante 60
elketefuka: posts the ante 60
Rdmulder: posts the ante 60
13LábúKárlosz: posts the ante 60
shipittosav7: posts the ante 60
Petey Pop: posts the ante 60
ALIENS100: posts small blind 250
@ferrazraf: posts big blind 500
*** HOLE CARDS ***
Dealt to elketefuka [3c Js]
elketefuka: folds
@ferrazraf has returned
Rdmulder: folds
13LábúKárlosz: folds
shipittosav7: folds
Petey Pop: folds
knedy10: raises 17912 to 18412 and is all-in
1the_specialone: folds
ALIENS100: folds
@ferrazraf: folds
Uncalled bet (17912) returned to knedy10
knedy10 collected 1790 from pot
knedy10: doesn't show hand
*** SUMMARY ***
Total pot 1790 | Rake 0
Seat 1: knedy10 collected (1790)
Seat 2: 1the_specialone (button) folded before Flop (didn't bet)
Seat 3: ALIENS100 (small blind) folded before Flop
Seat 4: @ferrazraf (big blind) folded before Flop
Seat 5: elketefuka folded before Flop (didn't bet)
Seat 6: Rdmulder folded before Flop (didn't bet)
Seat 7: 13LábúKárlosz folded before Flop (didn't bet)
Seat 8: shipittosav7 folded before Flop (didn't bet)
Seat 9: Petey Pop folded before Flop (didn't bet)


*********** # 113 **************
PokerStars Hand #214028574602: Tournament #2896837020, $0.98+$0.12 USD Hold'em No Limit - Level XIII (250/500) - 2020/05/17 11:33:58 ET
Table '2896837020 159' 9-max Seat #3 is the button
Seat 1: knedy10 (19702 in chips)
Seat 2: 1the_specialone (3008 in chips)
Seat 3: ALIENS100 (6060 in chips)
Seat 4: @ferrazraf (4130 in chips)
Seat 5: elketefuka (20725 in chips)
Seat 6: Rdmulder (17403 in chips)
Seat 7: 13LábúKárlosz (11786 in chips)
Seat 8: shipittosav7 (13454 in chips)
Seat 9: Petey Pop (3996 in chips)
knedy10: posts the ante 60
1the_specialone: posts the ante 60
ALIENS100: posts the ante 60
@ferrazraf: posts the ante 60
elketefuka: posts the ante 60
Rdmulder: posts the ante 60
13LábúKárlosz: posts the ante 60
shipittosav7: posts the ante 60
Petey Pop: posts the ante 60
@ferrazraf: posts small blind 250
elketefuka: posts big blind 500
*** HOLE CARDS ***
Dealt to elketefuka [2c 6d]
Rdmulder: folds
13LábúKárlosz: folds
shipittosav7: folds
Petey Pop: folds
knedy10: folds
1the_specialone: folds
ALIENS100: calls 500
@ferrazraf: raises 3570 to 4070 and is all-in
elketefuka: folds
ALIENS100: folds
Uncalled bet (3570) returned to @ferrazraf
@ferrazraf collected 2040 from pot
@ferrazraf: doesn't show hand
*** SUMMARY ***
Total pot 2040 | Rake 0
Seat 1: knedy10 folded before Flop (didn't bet)
Seat 2: 1the_specialone folded before Flop (didn't bet)
Seat 3: ALIENS100 (button) folded before Flop
Seat 4: @ferrazraf (small blind) collected (2040)
Seat 5: elketefuka (big blind) folded before Flop
Seat 6: Rdmulder folded before Flop (didn't bet)
Seat 7: 13LábúKárlosz folded before Flop (didn't bet)
Seat 8: shipittosav7 folded before Flop (didn't bet)
Seat 9: Petey Pop folded before Flop (didn't bet)


*********** # 114 **************
PokerStars Hand #214028618065: Tournament #2896837020, $0.98+$0.12 USD Hold'em No Limit - Level XIII (250/500) - 2020/05/17 11:34:46 ET
Table '2896837020 159' 9-max Seat #4 is the button
Seat 1: knedy10 (19642 in chips)
Seat 2: 1the_specialone (2948 in chips)
Seat 3: ALIENS100 (5500 in chips)
Seat 4: @ferrazraf (5610 in chips)
Seat 5: elketefuka (20165 in chips)
Seat 6: Rdmulder (17343 in chips)
Seat 7: 13LábúKárlosz (11726 in chips)
Seat 8: shipittosav7 (13394 in chips)
Seat 9: Petey Pop (3936 in chips)
knedy10: posts the ante 60
1the_specialone: posts the ante 60
ALIENS100: posts the ante 60
@ferrazraf: posts the ante 60
elketefuka: posts the ante 60
Rdmulder: posts the ante 60
13LábúKárlosz: posts the ante 60
shipittosav7: posts the ante 60
Petey Pop: posts the ante 60
elketefuka: posts small blind 250
Rdmulder: posts big blind 500
*** HOLE CARDS ***
Dealt to elketefuka [5d 3h]
13LábúKárlosz: folds
shipittosav7: folds
Petey Pop: folds
knedy10: folds
1the_specialone: raises 2388 to 2888 and is all-in
ALIENS100: calls 2888
@ferrazraf: folds
elketefuka: folds
Rdmulder: folds
*** FLOP *** [Qc Ks 7c]
*** TURN *** [Qc Ks 7c] [Tc]
*** RIVER *** [Qc Ks 7c Tc] [9h]
*** SHOW DOWN ***
1the_specialone: shows [7d 7h] (three of a kind, Sevens)
ALIENS100: shows [8d 8c] (a pair of Eights)
1the_specialone collected 7066 from pot
*** SUMMARY ***
Total pot 7066 | Rake 0
Board [Qc Ks 7c Tc 9h]
Seat 1: knedy10 folded before Flop (didn't bet)
Seat 2: 1the_specialone showed [7d 7h] and won (7066) with three of a kind, Sevens
Seat 3: ALIENS100 showed [8d 8c] and lost with a pair of Eights
Seat 4: @ferrazraf (button) folded before Flop (didn't bet)
Seat 5: elketefuka (small blind) folded before Flop
Seat 6: Rdmulder (big blind) folded before Flop
Seat 7: 13LábúKárlosz folded before Flop (didn't bet)
Seat 8: shipittosav7 folded before Flop (didn't bet)
Seat 9: Petey Pop folded before Flop (didn't bet)


*********** # 115 **************
PokerStars Hand #214028657551: Tournament #2896837020, $0.98+$0.12 USD Hold'em No Limit - Level XIII (250/500) - 2020/05/17 11:35:30 ET
Table '2896837020 159' 9-max Seat #5 is the button
Seat 1: knedy10 (19582 in chips)
Seat 2: 1the_specialone (7066 in chips)
Seat 3: ALIENS100 (2552 in chips)
Seat 4: @ferrazraf (5550 in chips)
Seat 5: elketefuka (19855 in chips)
Seat 6: Rdmulder (16783 in chips)
Seat 7: 13LábúKárlosz (11666 in chips)
Seat 8: shipittosav7 (13334 in chips)
Seat 9: Petey Pop (3876 in chips)
knedy10: posts the ante 60
1the_specialone: posts the ante 60
ALIENS100: posts the ante 60
@ferrazraf: posts the ante 60
elketefuka: posts the ante 60
Rdmulder: posts the ante 60
13LábúKárlosz: posts the ante 60
shipittosav7: posts the ante 60
Petey Pop: posts the ante 60
Rdmulder: posts small blind 250
13LábúKárlosz: posts big blind 500
*** HOLE CARDS ***
Dealt to elketefuka [9c 3d]
shipittosav7: folds
Petey Pop: folds
knedy10: folds
1the_specialone: folds
ALIENS100: folds
@ferrazraf: folds
elketefuka: calls 500
Rdmulder: folds
13LábúKárlosz: checks
*** FLOP *** [Ac 7s Kd]
13LábúKárlosz: checks
elketefuka: bets 1000
13LábúKárlosz: folds
Uncalled bet (1000) returned to elketefuka
elketefuka collected 1790 from pot
elketefuka: doesn't show hand
*** SUMMARY ***
Total pot 1790 | Rake 0
Board [Ac 7s Kd]
Seat 1: knedy10 folded before Flop (didn't bet)
Seat 2: 1the_specialone folded before Flop (didn't bet)
Seat 3: ALIENS100 folded before Flop (didn't bet)
Seat 4: @ferrazraf folded before Flop (didn't bet)
Seat 5: elketefuka (button) collected (1790)
Seat 6: Rdmulder (small blind) folded before Flop
Seat 7: 13LábúKárlosz (big blind) folded on the Flop
Seat 8: shipittosav7 folded before Flop (didn't bet)
Seat 9: Petey Pop folded before Flop (didn't bet)


*********** # 116 **************
PokerStars Hand #214028704786: Tournament #2896837020, $0.98+$0.12 USD Hold'em No Limit - Level XIII (250/500) - 2020/05/17 11:36:22 ET
Table '2896837020 159' 9-max Seat #6 is the button
Seat 1: knedy10 (19522 in chips)
Seat 2: 1the_specialone (7006 in chips)
Seat 3: ALIENS100 (2492 in chips)
Seat 4: @ferrazraf (5490 in chips)
Seat 5: elketefuka (21085 in chips)
Seat 6: Rdmulder (16473 in chips)
Seat 7: 13LábúKárlosz (11106 in chips)
Seat 8: shipittosav7 (13274 in chips)
Seat 9: Petey Pop (3816 in chips)
knedy10: posts the ante 60
1the_specialone: posts the ante 60
ALIENS100: posts the ante 60
@ferrazraf: posts the ante 60
elketefuka: posts the ante 60
Rdmulder: posts the ante 60
13LábúKárlosz: posts the ante 60
shipittosav7: posts the ante 60
Petey Pop: posts the ante 60
13LábúKárlosz: posts small blind 250
shipittosav7: posts big blind 500
*** HOLE CARDS ***
Dealt to elketefuka [5h Qs]
Petey Pop: folds
knedy10: folds
1the_specialone: folds
ALIENS100: folds
@ferrazraf: folds
elketefuka: folds
Rdmulder: folds
13LábúKárlosz: calls 250
shipittosav7: raises 2000 to 2500
13LábúKárlosz: folds
Uncalled bet (2000) returned to shipittosav7
shipittosav7 collected 1540 from pot
shipittosav7: doesn't show hand
*** SUMMARY ***
Total pot 1540 | Rake 0
Seat 1: knedy10 folded before Flop (didn't bet)
Seat 2: 1the_specialone folded before Flop (didn't bet)
Seat 3: ALIENS100 folded before Flop (didn't bet)
Seat 4: @ferrazraf folded before Flop (didn't bet)
Seat 5: elketefuka folded before Flop (didn't bet)
Seat 6: Rdmulder (button) folded before Flop (didn't bet)
Seat 7: 13LábúKárlosz (small blind) folded before Flop
Seat 8: shipittosav7 (big blind) collected (1540)
Seat 9: Petey Pop folded before Flop (didn't bet)


*********** # 117 **************
PokerStars Hand #214028747040: Tournament #2896837020, $0.98+$0.12 USD Hold'em No Limit - Level XIII (250/500) - 2020/05/17 11:37:09 ET
Table '2896837020 159' 9-max Seat #7 is the button
Seat 1: knedy10 (19462 in chips)
Seat 2: 1the_specialone (6946 in chips)
Seat 3: ALIENS100 (2432 in chips)
Seat 4: @ferrazraf (5430 in chips)
Seat 5: elketefuka (21025 in chips)
Seat 6: Rdmulder (16413 in chips)
Seat 7: 13LábúKárlosz (10546 in chips)
Seat 8: shipittosav7 (14254 in chips)
Seat 9: Petey Pop (3756 in chips)
knedy10: posts the ante 60
1the_specialone: posts the ante 60
ALIENS100: posts the ante 60
@ferrazraf: posts the ante 60
elketefuka: posts the ante 60
Rdmulder: posts the ante 60
13LábúKárlosz: posts the ante 60
shipittosav7: posts the ante 60
Petey Pop: posts the ante 60
shipittosav7: posts small blind 250
Petey Pop: posts big blind 500
*** HOLE CARDS ***
Dealt to elketefuka [7d 5s]
knedy10: folds
1the_specialone: folds
ALIENS100: folds
@ferrazraf: folds
elketefuka: folds
Rdmulder: folds
13LábúKárlosz: folds
shipittosav7: raises 1750 to 2250
Petey Pop: folds
Uncalled bet (1750) returned to shipittosav7
shipittosav7 collected 1540 from pot
shipittosav7: doesn't show hand
*** SUMMARY ***
Total pot 1540 | Rake 0
Seat 1: knedy10 folded before Flop (didn't bet)
Seat 2: 1the_specialone folded before Flop (didn't bet)
Seat 3: ALIENS100 folded before Flop (didn't bet)
Seat 4: @ferrazraf folded before Flop (didn't bet)
Seat 5: elketefuka folded before Flop (didn't bet)
Seat 6: Rdmulder folded before Flop (didn't bet)
Seat 7: 13LábúKárlosz (button) folded before Flop (didn't bet)
Seat 8: shipittosav7 (small blind) collected (1540)
Seat 9: Petey Pop (big blind) folded before Flop


*********** # 118 **************
PokerStars Hand #214028789759: Tournament #2896837020, $0.98+$0.12 USD Hold'em No Limit - Level XIII (250/500) - 2020/05/17 11:37:56 ET
Table '2896837020 159' 9-max Seat #8 is the button
Seat 1: knedy10 (19402 in chips)
Seat 2: 1the_specialone (6886 in chips)
Seat 3: ALIENS100 (2372 in chips)
Seat 4: @ferrazraf (5370 in chips)
Seat 5: elketefuka (20965 in chips)
Seat 6: Rdmulder (16353 in chips)
Seat 7: 13LábúKárlosz (10486 in chips)
Seat 8: shipittosav7 (15234 in chips)
Seat 9: Petey Pop (3196 in chips)
knedy10: posts the ante 60
1the_specialone: posts the ante 60
ALIENS100: posts the ante 60
@ferrazraf: posts the ante 60
elketefuka: posts the ante 60
Rdmulder: posts the ante 60
13LábúKárlosz: posts the ante 60
shipittosav7: posts the ante 60
Petey Pop: posts the ante 60
Petey Pop: posts small blind 250
knedy10: posts big blind 500
*** HOLE CARDS ***
Dealt to elketefuka [9h 7s]
1the_specialone: folds
ALIENS100: folds
@ferrazraf: folds
elketefuka: folds
Rdmulder: raises 600 to 1100
13LábúKárlosz: folds
shipittosav7: folds
Petey Pop: folds
knedy10: folds
Uncalled bet (600) returned to Rdmulder
Rdmulder collected 1790 from pot
Rdmulder: doesn't show hand
*** SUMMARY ***
Total pot 1790 | Rake 0
Seat 1: knedy10 (big blind) folded before Flop
Seat 2: 1the_specialone folded before Flop (didn't bet)
Seat 3: ALIENS100 folded before Flop (didn't bet)
Seat 4: @ferrazraf folded before Flop (didn't bet)
Seat 5: elketefuka folded before Flop (didn't bet)
Seat 6: Rdmulder collected (1790)
Seat 7: 13LábúKárlosz folded before Flop (didn't bet)
Seat 8: shipittosav7 (button) folded before Flop (didn't bet)
Seat 9: Petey Pop (small blind) folded before Flop


*********** # 119 **************
PokerStars Hand #214028835169: Tournament #2896837020, $0.98+$0.12 USD Hold'em No Limit - Level XIII (250/500) - 2020/05/17 11:38:47 ET
Table '2896837020 159' 9-max Seat #9 is the button
Seat 1: knedy10 (18842 in chips)
Seat 2: 1the_specialone (6826 in chips)
Seat 3: ALIENS100 (2312 in chips)
Seat 4: @ferrazraf (5310 in chips)
Seat 5: elketefuka (20905 in chips)
Seat 6: Rdmulder (17583 in chips)
Seat 7: 13LábúKárlosz (10426 in chips)
Seat 8: shipittosav7 (15174 in chips)
Seat 9: Petey Pop (2886 in chips)
knedy10: posts the ante 60
1the_specialone: posts the ante 60
ALIENS100: posts the ante 60
@ferrazraf: posts the ante 60
elketefuka: posts the ante 60
Rdmulder: posts the ante 60
13LábúKárlosz: posts the ante 60
shipittosav7: posts the ante 60
Petey Pop: posts the ante 60
knedy10: posts small blind 250
1the_specialone: posts big blind 500
*** HOLE CARDS ***
Dealt to elketefuka [8c 7s]
ALIENS100: folds
@ferrazraf: folds
elketefuka: folds
Rdmulder: folds
13LábúKárlosz: raises 750 to 1250
shipittosav7: folds
Petey Pop: folds
knedy10: folds
1the_specialone: folds
Uncalled bet (750) returned to 13LábúKárlosz
13LábúKárlosz collected 1790 from pot
13LábúKárlosz: doesn't show hand
*** SUMMARY ***
Total pot 1790 | Rake 0
Seat 1: knedy10 (small blind) folded before Flop
Seat 2: 1the_specialone (big blind) folded before Flop
Seat 3: ALIENS100 folded before Flop (didn't bet)
Seat 4: @ferrazraf folded before Flop (didn't bet)
Seat 5: elketefuka folded before Flop (didn't bet)
Seat 6: Rdmulder folded before Flop (didn't bet)
Seat 7: 13LábúKárlosz collected (1790)
Seat 8: shipittosav7 folded before Flop (didn't bet)
Seat 9: Petey Pop (button) folded before Flop (didn't bet)


*********** # 120 **************
PokerStars Hand #214028955790: Tournament #2896837020, $0.98+$0.12 USD Hold'em No Limit - Level XIV (300/600) - 2020/05/17 11:40:54 ET
Table '2896837020 159' 9-max Seat #1 is the button
Seat 1: knedy10 (18532 in chips)
Seat 2: 1the_specialone (6266 in chips)
Seat 3: ALIENS100 (2252 in chips)
Seat 4: @ferrazraf (5250 in chips)
Seat 5: elketefuka (20845 in chips)
Seat 6: Rdmulder (17523 in chips)
Seat 7: 13LábúKárlosz (11656 in chips)
Seat 8: shipittosav7 (15114 in chips)
Seat 9: Petey Pop (2826 in chips)
knedy10: posts the ante 70
1the_specialone: posts the ante 70
ALIENS100: posts the ante 70
@ferrazraf: posts the ante 70
elketefuka: posts the ante 70
Rdmulder: posts the ante 70
13LábúKárlosz: posts the ante 70
shipittosav7: posts the ante 70
Petey Pop: posts the ante 70
1the_specialone: posts small blind 300
ALIENS100: posts big blind 600
*** HOLE CARDS ***
Dealt to elketefuka [3c 4h]
@ferrazraf: raises 4580 to 5180 and is all-in
elketefuka: folds
Rdmulder: folds
13LábúKárlosz: folds
shipittosav7: folds
Petey Pop: folds
knedy10: folds
1the_specialone: folds
ALIENS100: folds
Uncalled bet (4580) returned to @ferrazraf
@ferrazraf collected 2130 from pot
@ferrazraf: doesn't show hand
*** SUMMARY ***
Total pot 2130 | Rake 0
Seat 1: knedy10 (button) folded before Flop (didn't bet)
Seat 2: 1the_specialone (small blind) folded before Flop
Seat 3: ALIENS100 (big blind) folded before Flop
Seat 4: @ferrazraf collected (2130)
Seat 5: elketefuka folded before Flop (didn't bet)
Seat 6: Rdmulder folded before Flop (didn't bet)
Seat 7: 13LábúKárlosz folded before Flop (didn't bet)
Seat 8: shipittosav7 folded before Flop (didn't bet)
Seat 9: Petey Pop folded before Flop (didn't bet)


*********** # 121 **************
PokerStars Hand #214028980823: Tournament #2896837020, $0.98+$0.12 USD Hold'em No Limit - Level XIV (300/600) - 2020/05/17 11:41:21 ET
Table '2896837020 159' 9-max Seat #2 is the button
Seat 1: knedy10 (18462 in chips)
Seat 2: 1the_specialone (5896 in chips)
Seat 3: ALIENS100 (1582 in chips)
Seat 4: @ferrazraf (6710 in chips)
Seat 5: elketefuka (20775 in chips)
Seat 6: Rdmulder (17453 in chips)
Seat 7: 13LábúKárlosz (11586 in chips)
Seat 8: shipittosav7 (15044 in chips)
Seat 9: Petey Pop (2756 in chips)
knedy10: posts the ante 70
1the_specialone: posts the ante 70
ALIENS100: posts the ante 70
@ferrazraf: posts the ante 70
elketefuka: posts the ante 70
Rdmulder: posts the ante 70
13LábúKárlosz: posts the ante 70
shipittosav7: posts the ante 70
Petey Pop: posts the ante 70
ALIENS100: posts small blind 300
@ferrazraf: posts big blind 600
*** HOLE CARDS ***
Dealt to elketefuka [6d Qc]
elketefuka: folds
Rdmulder: raises 900 to 1500
13LábúKárlosz: folds
shipittosav7: folds
Petey Pop: folds
knedy10: folds
1the_specialone: folds
ALIENS100: raises 12 to 1512 and is all-in
@ferrazraf: raises 5128 to 6640 and is all-in
Rdmulder: calls 5140
*** FLOP *** [Jd 3d 3s]
*** TURN *** [Jd 3d 3s] [3h]
*** RIVER *** [Jd 3d 3s 3h] [Ad]
*** SHOW DOWN ***
@ferrazraf: shows [Ah As] (a full house, Aces full of Threes)
Rdmulder: shows [5c 5d] (a full house, Threes full of Fives)
@ferrazraf collected 10256 from side pot
ALIENS100: shows [Ac 8h] (a full house, Threes full of Aces)
@ferrazraf collected 5166 from main pot
ALIENS100 finished the tournament in 709th place and received $1.73.
*** SUMMARY ***
Total pot 15422 Main pot 5166. Side pot 10256. | Rake 0
Board [Jd 3d 3s 3h Ad]
Seat 1: knedy10 folded before Flop (didn't bet)
Seat 2: 1the_specialone (button) folded before Flop (didn't bet)
Seat 3: ALIENS100 (small blind) showed [Ac 8h] and lost with a full house, Threes full of Aces
Seat 4: @ferrazraf (big blind) showed [Ah As] and won (15422) with a full house, Aces full of Threes
Seat 5: elketefuka folded before Flop (didn't bet)
Seat 6: Rdmulder showed [5c 5d] and lost with a full house, Threes full of Fives
Seat 7: 13LábúKárlosz folded before Flop (didn't bet)
Seat 8: shipittosav7 folded before Flop (didn't bet)
Seat 9: Petey Pop folded before Flop (didn't bet)


*********** # 122 **************
PokerStars Hand #214029034404: Tournament #2896837020, $0.98+$0.12 USD Hold'em No Limit - Level XIV (300/600) - 2020/05/17 11:42:20 ET
Table '2896837020 159' 9-max Seat #4 is the button
Seat 1: knedy10 (18392 in chips)
Seat 2: 1the_specialone (5826 in chips)
Seat 4: @ferrazraf (15422 in chips)
Seat 5: elketefuka (20705 in chips)
Seat 6: Rdmulder (10743 in chips)
Seat 7: 13LábúKárlosz (11516 in chips)
Seat 8: shipittosav7 (14974 in chips)
Seat 9: Petey Pop (2686 in chips)
knedy10: posts the ante 70
1the_specialone: posts the ante 70
@ferrazraf: posts the ante 70
elketefuka: posts the ante 70
Rdmulder: posts the ante 70
13LábúKárlosz: posts the ante 70
shipittosav7: posts the ante 70
Petey Pop: posts the ante 70
elketefuka: posts small blind 300
Rdmulder: posts big blind 600
*** HOLE CARDS ***
Dealt to elketefuka [6h Ad]
13LábúKárlosz: folds
shipittosav7: folds
Petey Pop: folds
knedy10: folds
1the_specialone: folds
@ferrazraf: folds
elketefuka: calls 300
Rdmulder: checks
*** FLOP *** [9h 3c 2s]
elketefuka: bets 600
Rdmulder: folds
Uncalled bet (600) returned to elketefuka
elketefuka collected 1760 from pot
elketefuka: doesn't show hand
*** SUMMARY ***
Total pot 1760 | Rake 0
Board [9h 3c 2s]
Seat 1: knedy10 folded before Flop (didn't bet)
Seat 2: 1the_specialone folded before Flop (didn't bet)
Seat 4: @ferrazraf (button) folded before Flop (didn't bet)
Seat 5: elketefuka (small blind) collected (1760)
Seat 6: Rdmulder (big blind) folded on the Flop
Seat 7: 13LábúKárlosz folded before Flop (didn't bet)
Seat 8: shipittosav7 folded before Flop (didn't bet)
Seat 9: Petey Pop folded before Flop (didn't bet)


*********** # 123 **************
PokerStars Hand #214029057633: Tournament #2896837020, $0.98+$0.12 USD Hold'em No Limit - Level XIV (300/600) - 2020/05/17 11:42:46 ET
Table '2896837020 159' 9-max Seat #5 is the button
Seat 1: knedy10 (18322 in chips)
Seat 2: 1the_specialone (5756 in chips)
Seat 3: ricster8347 (14741 in chips)
Seat 4: @ferrazraf (15352 in chips)
Seat 5: elketefuka (21795 in chips)
Seat 6: Rdmulder (10073 in chips)
Seat 7: 13LábúKárlosz (11446 in chips)
Seat 8: shipittosav7 (14904 in chips)
Seat 9: Petey Pop (2616 in chips)
knedy10: posts the ante 70
1the_specialone: posts the ante 70
ricster8347: posts the ante 70
@ferrazraf: posts the ante 70
elketefuka: posts the ante 70
Rdmulder: posts the ante 70
13LábúKárlosz: posts the ante 70
shipittosav7: posts the ante 70
Petey Pop: posts the ante 70
Rdmulder: posts small blind 300
13LábúKárlosz: posts big blind 600
*** HOLE CARDS ***
Dealt to elketefuka [Kc Th]
shipittosav7: folds
Petey Pop: folds
knedy10: folds
1the_specialone: folds
ricster8347: folds
@ferrazraf: folds
elketefuka: raises 600 to 1200
Rdmulder: folds
13LábúKárlosz: raises 10176 to 11376 and is all-in
elketefuka: folds
Uncalled bet (10176) returned to 13LábúKárlosz
13LábúKárlosz collected 3330 from pot
13LábúKárlosz: doesn't show hand
*** SUMMARY ***
Total pot 3330 | Rake 0
Seat 1: knedy10 folded before Flop (didn't bet)
Seat 2: 1the_specialone folded before Flop (didn't bet)
Seat 3: ricster8347 folded before Flop (didn't bet)
Seat 4: @ferrazraf folded before Flop (didn't bet)
Seat 5: elketefuka (button) folded before Flop
Seat 6: Rdmulder (small blind) folded before Flop
Seat 7: 13LábúKárlosz (big blind) collected (3330)
Seat 8: shipittosav7 folded before Flop (didn't bet)
Seat 9: Petey Pop folded before Flop (didn't bet)


*********** # 124 **************
PokerStars Hand #214029090268: Tournament #2896837020, $0.98+$0.12 USD Hold'em No Limit - Level XIV (300/600) - 2020/05/17 11:43:22 ET
Table '2896837020 159' 9-max Seat #6 is the button
Seat 1: knedy10 (18252 in chips)
Seat 2: 1the_specialone (5686 in chips)
Seat 3: ricster8347 (14671 in chips)
Seat 4: @ferrazraf (15282 in chips)
Seat 5: elketefuka (20525 in chips)
Seat 6: Rdmulder (9703 in chips)
Seat 7: 13LábúKárlosz (13506 in chips)
Seat 8: shipittosav7 (14834 in chips)
Seat 9: Petey Pop (2546 in chips)
knedy10: posts the ante 70
1the_specialone: posts the ante 70
ricster8347: posts the ante 70
@ferrazraf: posts the ante 70
elketefuka: posts the ante 70
Rdmulder: posts the ante 70
13LábúKárlosz: posts the ante 70
shipittosav7: posts the ante 70
Petey Pop: posts the ante 70
13LábúKárlosz: posts small blind 300
shipittosav7: posts big blind 600
*** HOLE CARDS ***
Dealt to elketefuka [6c 2c]
Petey Pop: folds
knedy10: raises 780 to 1380
1the_specialone: folds
ricster8347: folds
@ferrazraf: folds
elketefuka: folds
Rdmulder: folds
13LábúKárlosz: folds
shipittosav7: folds
Uncalled bet (780) returned to knedy10
knedy10 collected 2130 from pot
knedy10: doesn't show hand
*** SUMMARY ***
Total pot 2130 | Rake 0
Seat 1: knedy10 collected (2130)
Seat 2: 1the_specialone folded before Flop (didn't bet)
Seat 3: ricster8347 folded before Flop (didn't bet)
Seat 4: @ferrazraf folded before Flop (didn't bet)
Seat 5: elketefuka folded before Flop (didn't bet)
Seat 6: Rdmulder (button) folded before Flop (didn't bet)
Seat 7: 13LábúKárlosz (small blind) folded before Flop
Seat 8: shipittosav7 (big blind) folded before Flop
Seat 9: Petey Pop folded before Flop (didn't bet)


*********** # 125 **************
PokerStars Hand #214029124257: Tournament #2896837020, $0.98+$0.12 USD Hold'em No Limit - Level XIV (300/600) - 2020/05/17 11:43:59 ET
Table '2896837020 159' 9-max Seat #7 is the button
Seat 1: knedy10 (19712 in chips)
Seat 2: 1the_specialone (5616 in chips)
Seat 3: ricster8347 (14601 in chips)
Seat 4: @ferrazraf (15212 in chips)
Seat 5: elketefuka (20455 in chips)
Seat 6: Rdmulder (9633 in chips)
Seat 7: 13LábúKárlosz (13136 in chips)
Seat 8: shipittosav7 (14164 in chips)
Seat 9: Petey Pop (2476 in chips)
knedy10: posts the ante 70
1the_specialone: posts the ante 70
ricster8347: posts the ante 70
@ferrazraf: posts the ante 70
elketefuka: posts the ante 70
Rdmulder: posts the ante 70
13LábúKárlosz: posts the ante 70
shipittosav7: posts the ante 70
Petey Pop: posts the ante 70
shipittosav7: posts small blind 300
Petey Pop: posts big blind 600
*** HOLE CARDS ***
Dealt to elketefuka [5d 3d]
knedy10: raises 600 to 1200
1the_specialone: folds
ricster8347: folds
@ferrazraf: raises 1680 to 2880
elketefuka: folds
Rdmulder: folds
13LábúKárlosz: calls 2880
shipittosav7: folds
Petey Pop: folds
knedy10: calls 1680
*** FLOP *** [Qh 2h 9s]
knedy10: checks
@ferrazraf: bets 3356
13LábúKárlosz: raises 6830 to 10186 and is all-in
knedy10: folds
@ferrazraf: calls 6830
*** TURN *** [Qh 2h 9s] [4c]
*** RIVER *** [Qh 2h 9s 4c] [4s]
*** SHOW DOWN ***
@ferrazraf: shows [Kd As] (a pair of Fours)
13LábúKárlosz: shows [Qs Ac] (two pair, Queens and Fours)
13LábúKárlosz collected 30542 from pot
*** SUMMARY ***
Total pot 30542 | Rake 0
Board [Qh 2h 9s 4c 4s]
Seat 1: knedy10 folded on the Flop
Seat 2: 1the_specialone folded before Flop (didn't bet)
Seat 3: ricster8347 folded before Flop (didn't bet)
Seat 4: @ferrazraf showed [Kd As] and lost with a pair of Fours
Seat 5: elketefuka folded before Flop (didn't bet)
Seat 6: Rdmulder folded before Flop (didn't bet)
Seat 7: 13LábúKárlosz (button) showed [Qs Ac] and won (30542) with two pair, Queens and Fours
Seat 8: shipittosav7 (small blind) folded before Flop
Seat 9: Petey Pop (big blind) folded before Flop


*********** # 126 **************
PokerStars Hand #214029191864: Tournament #2896837020, $0.98+$0.12 USD Hold'em No Limit - Level XIV (300/600) - 2020/05/17 11:45:13 ET
Table '2896837020 159' 9-max Seat #8 is the button
Seat 1: knedy10 (16762 in chips)
Seat 2: 1the_specialone (5546 in chips)
Seat 3: ricster8347 (14531 in chips)
Seat 4: @ferrazraf (2076 in chips)
Seat 5: elketefuka (20385 in chips)
Seat 6: Rdmulder (9563 in chips)
Seat 7: 13LábúKárlosz (30542 in chips)
Seat 8: shipittosav7 (13794 in chips)
Seat 9: Petey Pop (1806 in chips)
knedy10: posts the ante 70
1the_specialone: posts the ante 70
ricster8347: posts the ante 70
@ferrazraf: posts the ante 70
elketefuka: posts the ante 70
Rdmulder: posts the ante 70
13LábúKárlosz: posts the ante 70
shipittosav7: posts the ante 70
Petey Pop: posts the ante 70
Petey Pop: posts small blind 300
knedy10: posts big blind 600
*** HOLE CARDS ***
Dealt to elketefuka [Js Ah]
1the_specialone: folds
ricster8347: raises 1200 to 1800
@ferrazraf: folds
elketefuka: calls 1800
Rdmulder: folds
13LábúKárlosz: folds
shipittosav7: folds
Petey Pop: folds
knedy10: folds
*** FLOP *** [7h 5h Ad]
ricster8347: bets 2565
elketefuka: raises 15950 to 18515 and is all-in
ricster8347: calls 10096 and is all-in
Uncalled bet (5854) returned to elketefuka
*** TURN *** [7h 5h Ad] [7s]
*** RIVER *** [7h 5h Ad 7s] [Kc]
*** SHOW DOWN ***
ricster8347: shows [As Qs] (two pair, Aces and Sevens)
elketefuka: shows [Js Ah] (two pair, Aces and Sevens)
ricster8347 collected 15226 from pot
elketefuka collected 15226 from pot
*** SUMMARY ***
Total pot 30452 | Rake 0
Board [7h 5h Ad 7s Kc]
Seat 1: knedy10 (big blind) folded before Flop
Seat 2: 1the_specialone folded before Flop (didn't bet)
Seat 3: ricster8347 showed [As Qs] and won (15226) with two pair, Aces and Sevens
Seat 4: @ferrazraf folded before Flop (didn't bet)
Seat 5: elketefuka showed [Js Ah] and won (15226) with two pair, Aces and Sevens
Seat 6: Rdmulder folded before Flop (didn't bet)
Seat 7: 13LábúKárlosz folded before Flop (didn't bet)
Seat 8: shipittosav7 (button) folded before Flop (didn't bet)
Seat 9: Petey Pop (small blind) folded before Flop


*********** # 127 **************
PokerStars Hand #214029256186: Tournament #2896837020, $0.98+$0.12 USD Hold'em No Limit - Level XIV (300/600) - 2020/05/17 11:46:23 ET
Table '2896837020 159' 9-max Seat #9 is the button
Seat 1: knedy10 (16092 in chips)
Seat 2: 1the_specialone (5476 in chips)
Seat 3: ricster8347 (15226 in chips)
Seat 4: @ferrazraf (2006 in chips)
Seat 5: elketefuka (21080 in chips)
Seat 6: Rdmulder (9493 in chips)
Seat 7: 13LábúKárlosz (30472 in chips)
Seat 8: shipittosav7 (13724 in chips)
Seat 9: Petey Pop (1436 in chips)
knedy10: posts the ante 70
1the_specialone: posts the ante 70
ricster8347: posts the ante 70
@ferrazraf: posts the ante 70
elketefuka: posts the ante 70
Rdmulder: posts the ante 70
13LábúKárlosz: posts the ante 70
shipittosav7: posts the ante 70
Petey Pop: posts the ante 70
knedy10: posts small blind 300
1the_specialone: posts big blind 600
*** HOLE CARDS ***
Dealt to elketefuka [7h 8s]
ricster8347: folds
@ferrazraf: raises 1336 to 1936 and is all-in
elketefuka: folds
Rdmulder: folds
13LábúKárlosz: folds
shipittosav7: folds
Petey Pop: folds
knedy10: folds
1the_specialone: calls 1336
*** FLOP *** [5c 4h 2c]
*** TURN *** [5c 4h 2c] [2d]
*** RIVER *** [5c 4h 2c 2d] [7d]
*** SHOW DOWN ***
1the_specialone: shows [3d 4d] (two pair, Fours and Deuces)
@ferrazraf: shows [Ts Kd] (a pair of Deuces)
1the_specialone collected 4802 from pot
@ferrazraf finished the tournament in 626th place and received $1.73.
*** SUMMARY ***
Total pot 4802 | Rake 0
Board [5c 4h 2c 2d 7d]
Seat 1: knedy10 (small blind) folded before Flop
Seat 2: 1the_specialone (big blind) showed [3d 4d] and won (4802) with two pair, Fours and Deuces
Seat 3: ricster8347 folded before Flop (didn't bet)
Seat 4: @ferrazraf showed [Ts Kd] and lost with a pair of Deuces
Seat 5: elketefuka folded before Flop (didn't bet)
Seat 6: Rdmulder folded before Flop (didn't bet)
Seat 7: 13LábúKárlosz folded before Flop (didn't bet)
Seat 8: shipittosav7 folded before Flop (didn't bet)
Seat 9: Petey Pop (button) folded before Flop (didn't bet)


*********** # 128 **************
PokerStars Hand #214029284904: Tournament #2896837020, $0.98+$0.12 USD Hold'em No Limit - Level XIV (300/600) - 2020/05/17 11:46:55 ET
Table '2896837020 159' 9-max Seat #1 is the button
Seat 1: knedy10 (15722 in chips)
Seat 2: 1the_specialone (8272 in chips)
Seat 3: ricster8347 (15156 in chips)
Seat 5: elketefuka (21010 in chips)
Seat 6: Rdmulder (9423 in chips)
Seat 7: 13LábúKárlosz (30402 in chips)
Seat 8: shipittosav7 (13654 in chips)
Seat 9: Petey Pop (1366 in chips)
knedy10: posts the ante 70
1the_specialone: posts the ante 70
ricster8347: posts the ante 70
elketefuka: posts the ante 70
Rdmulder: posts the ante 70
13LábúKárlosz: posts the ante 70
shipittosav7: posts the ante 70
Petey Pop: posts the ante 70
1the_specialone: posts small blind 300
ricster8347: posts big blind 600
*** HOLE CARDS ***
Dealt to elketefuka [Th 4s]
elketefuka: folds
Rdmulder: calls 600
13LábúKárlosz: folds
shipittosav7: folds
Petey Pop: folds
knedy10: raises 15052 to 15652 and is all-in
1the_specialone: folds
ricster8347: folds
Rdmulder: folds
Uncalled bet (15052) returned to knedy10
knedy10 collected 2660 from pot
knedy10: doesn't show hand
*** SUMMARY ***
Total pot 2660 | Rake 0
Seat 1: knedy10 (button) collected (2660)
Seat 2: 1the_specialone (small blind) folded before Flop
Seat 3: ricster8347 (big blind) folded before Flop
Seat 5: elketefuka folded before Flop (didn't bet)
Seat 6: Rdmulder folded before Flop
Seat 7: 13LábúKárlosz folded before Flop (didn't bet)
Seat 8: shipittosav7 folded before Flop (didn't bet)
Seat 9: Petey Pop folded before Flop (didn't bet)


*********** # 129 **************
PokerStars Hand #214029319100: Tournament #2896837020, $0.98+$0.12 USD Hold'em No Limit - Level XIV (300/600) - 2020/05/17 11:47:30 ET
Table '2896837020 159' 9-max Seat #2 is the button
Seat 1: knedy10 (17712 in chips)
Seat 2: 1the_specialone (7902 in chips)
Seat 3: ricster8347 (14486 in chips)
Seat 4: grandpauly (32422 in chips)
Seat 5: elketefuka (20940 in chips)
Seat 6: Rdmulder (8753 in chips)
Seat 7: 13LábúKárlosz (30332 in chips)
Seat 8: shipittosav7 (13584 in chips)
Seat 9: Petey Pop (1296 in chips)
knedy10: posts the ante 70
1the_specialone: posts the ante 70
ricster8347: posts the ante 70
grandpauly: posts the ante 70
elketefuka: posts the ante 70
Rdmulder: posts the ante 70
13LábúKárlosz: posts the ante 70
shipittosav7: posts the ante 70
Petey Pop: posts the ante 70
ricster8347: posts small blind 300
grandpauly: posts big blind 600
*** HOLE CARDS ***
Dealt to elketefuka [5h 7s]
elketefuka: folds
Rdmulder: calls 600
13LábúKárlosz: folds
shipittosav7: folds
Petey Pop: folds
knedy10: folds
1the_specialone: folds
ricster8347: calls 300
grandpauly: checks
*** FLOP *** [Jc 9h 7c]
ricster8347: checks
grandpauly: bets 600
Rdmulder: calls 600
ricster8347: folds
*** TURN *** [Jc 9h 7c] [Qd]
grandpauly: checks
Rdmulder: checks
*** RIVER *** [Jc 9h 7c Qd] [Ah]
grandpauly: bets 3630
Rdmulder: folds
Uncalled bet (3630) returned to grandpauly
grandpauly collected 3630 from pot
*** SUMMARY ***
Total pot 3630 | Rake 0
Board [Jc 9h 7c Qd Ah]
Seat 1: knedy10 folded before Flop (didn't bet)
Seat 2: 1the_specialone (button) folded before Flop (didn't bet)
Seat 3: ricster8347 (small blind) folded on the Flop
Seat 4: grandpauly (big blind) collected (3630)
Seat 5: elketefuka folded before Flop (didn't bet)
Seat 6: Rdmulder folded on the River
Seat 7: 13LábúKárlosz folded before Flop (didn't bet)
Seat 8: shipittosav7 folded before Flop (didn't bet)
Seat 9: Petey Pop folded before Flop (didn't bet)


*********** # 130 **************
PokerStars Hand #214029381003: Tournament #2896837020, $0.98+$0.12 USD Hold'em No Limit - Level XIV (300/600) - 2020/05/17 11:48:38 ET
Table '2896837020 159' 9-max Seat #3 is the button
Seat 1: knedy10 (17642 in chips)
Seat 2: 1the_specialone (7832 in chips)
Seat 3: ricster8347 (13816 in chips)
Seat 4: grandpauly (34782 in chips)
Seat 5: elketefuka (20870 in chips)
Seat 6: Rdmulder (7483 in chips)
Seat 7: 13LábúKárlosz (30262 in chips)
Seat 8: shipittosav7 (13514 in chips)
Seat 9: Petey Pop (1226 in chips)
knedy10: posts the ante 70
1the_specialone: posts the ante 70
ricster8347: posts the ante 70
grandpauly: posts the ante 70
elketefuka: posts the ante 70
Rdmulder: posts the ante 70
13LábúKárlosz: posts the ante 70
shipittosav7: posts the ante 70
Petey Pop: posts the ante 70
grandpauly: posts small blind 300
elketefuka: posts big blind 600
*** HOLE CARDS ***
Dealt to elketefuka [7c Qc]
Rdmulder: folds
13LábúKárlosz: raises 900 to 1500
shipittosav7: folds
Petey Pop: folds
knedy10: folds
1the_specialone: folds
ricster8347: folds
grandpauly: calls 1200
elketefuka: calls 900
*** FLOP *** [Qh Kd 3d]
grandpauly: bets 2565
elketefuka: folds
13LábúKárlosz: calls 2565
*** TURN *** [Qh Kd 3d] [9s]
grandpauly: bets 5130
13LábúKárlosz: calls 5130
*** RIVER *** [Qh Kd 3d 9s] [3h]
grandpauly: bets 10260
13LábúKárlosz: calls 10260
*** SHOW DOWN ***
grandpauly: shows [5s Ks] (two pair, Kings and Threes)
13LábúKárlosz: shows [Ac Kc] (two pair, Kings and Threes - Ace kicker)
13LábúKárlosz collected 41040 from pot
*** SUMMARY ***
Total pot 41040 | Rake 0
Board [Qh Kd 3d 9s 3h]
Seat 1: knedy10 folded before Flop (didn't bet)
Seat 2: 1the_specialone folded before Flop (didn't bet)
Seat 3: ricster8347 (button) folded before Flop (didn't bet)
Seat 4: grandpauly (small blind) showed [5s Ks] and lost with two pair, Kings and Threes
Seat 5: elketefuka (big blind) folded on the Flop
Seat 6: Rdmulder folded before Flop (didn't bet)
Seat 7: 13LábúKárlosz showed [Ac Kc] and won (41040) with two pair, Kings and Threes
Seat 8: shipittosav7 folded before Flop (didn't bet)
Seat 9: Petey Pop folded before Flop (didn't bet)


*********** # 131 **************
PokerStars Hand #214029444266: Tournament #2896837020, $0.98+$0.12 USD Hold'em No Limit - Level XV (350/700) - 2020/05/17 11:49:48 ET
Table '2896837020 159' 9-max Seat #4 is the button
Seat 1: knedy10 (17572 in chips)
Seat 2: 1the_specialone (7762 in chips)
Seat 3: ricster8347 (13746 in chips)
Seat 4: grandpauly (15257 in chips)
Seat 5: elketefuka (19300 in chips)
Seat 6: Rdmulder (7413 in chips)
Seat 7: 13LábúKárlosz (51777 in chips)
Seat 8: shipittosav7 (13444 in chips)
Seat 9: Petey Pop (1156 in chips)
knedy10: posts the ante 85
1the_specialone: posts the ante 85
ricster8347: posts the ante 85
grandpauly: posts the ante 85
elketefuka: posts the ante 85
Rdmulder: posts the ante 85
13LábúKárlosz: posts the ante 85
shipittosav7: posts the ante 85
Petey Pop: posts the ante 85
elketefuka: posts small blind 350
Rdmulder: posts big blind 700
*** HOLE CARDS ***
Dealt to elketefuka [3h 4d]
13LábúKárlosz: folds
shipittosav7: folds
Petey Pop: folds
knedy10: raises 910 to 1610
1the_specialone: folds
ricster8347: folds
grandpauly: calls 1610
elketefuka: folds
Rdmulder: raises 5718 to 7328 and is all-in
knedy10: raises 10159 to 17487 and is all-in
grandpauly: calls 13562 and is all-in
Uncalled bet (2315) returned to knedy10
*** FLOP *** [6s Ah 5c]
*** TURN *** [6s Ah 5c] [2d]
*** RIVER *** [6s Ah 5c 2d] [5d]
*** SHOW DOWN ***
knedy10: shows [Qc Kd] (a pair of Fives)
grandpauly: shows [8h 8d] (two pair, Eights and Fives)
grandpauly collected 15688 from side pot
Rdmulder: shows [9s 9d] (two pair, Nines and Fives)
Rdmulder collected 23099 from main pot
*** SUMMARY ***
Total pot 38787 Main pot 23099. Side pot 15688. | Rake 0
Board [6s Ah 5c 2d 5d]
Seat 1: knedy10 showed [Qc Kd] and lost with a pair of Fives
Seat 2: 1the_specialone folded before Flop (didn't bet)
Seat 3: ricster8347 folded before Flop (didn't bet)
Seat 4: grandpauly (button) showed [8h 8d] and won (15688) with two pair, Eights and Fives
Seat 5: elketefuka (small blind) folded before Flop
Seat 6: Rdmulder (big blind) showed [9s 9d] and won (23099) with two pair, Nines and Fives
Seat 7: 13LábúKárlosz folded before Flop (didn't bet)
Seat 8: shipittosav7 folded before Flop (didn't bet)
Seat 9: Petey Pop folded before Flop (didn't bet)


*********** # 132 **************
PokerStars Hand #214029485079: Tournament #2896837020, $0.98+$0.12 USD Hold'em No Limit - Level XV (350/700) - 2020/05/17 11:50:33 ET
Table '2896837020 159' 9-max Seat #5 is the button
Seat 1: knedy10 (2315 in chips)
Seat 2: 1the_specialone (7677 in chips)
Seat 3: ricster8347 (13661 in chips)
Seat 4: grandpauly (15688 in chips)
Seat 5: elketefuka (18865 in chips)
Seat 6: Rdmulder (23099 in chips)
Seat 7: 13LábúKárlosz (51692 in chips)
Seat 8: shipittosav7 (13359 in chips)
Seat 9: Petey Pop (1071 in chips)
knedy10: posts the ante 85
1the_specialone: posts the ante 85
ricster8347: posts the ante 85
grandpauly: posts the ante 85
elketefuka: posts the ante 85
Rdmulder: posts the ante 85
13LábúKárlosz: posts the ante 85
shipittosav7: posts the ante 85
Petey Pop: posts the ante 85
Rdmulder: posts small blind 350
13LábúKárlosz: posts big blind 700
*** HOLE CARDS ***
Dealt to elketefuka [Kd 8h]
shipittosav7: folds
Petey Pop: folds
knedy10: folds
1the_specialone: folds
ricster8347: folds
grandpauly: folds
elketefuka: calls 700
Rdmulder: folds
13LábúKárlosz: checks
*** FLOP *** [4h Jh Kc]
13LábúKárlosz: checks
elketefuka: bets 1400
13LábúKárlosz: folds
Uncalled bet (1400) returned to elketefuka
elketefuka collected 2515 from pot
elketefuka: doesn't show hand
*** SUMMARY ***
Total pot 2515 | Rake 0
Board [4h Jh Kc]
Seat 1: knedy10 folded before Flop (didn't bet)
Seat 2: 1the_specialone folded before Flop (didn't bet)
Seat 3: ricster8347 folded before Flop (didn't bet)
Seat 4: grandpauly folded before Flop (didn't bet)
Seat 5: elketefuka (button) collected (2515)
Seat 6: Rdmulder (small blind) folded before Flop
Seat 7: 13LábúKárlosz (big blind) folded on the Flop
Seat 8: shipittosav7 folded before Flop (didn't bet)
Seat 9: Petey Pop folded before Flop (didn't bet)


*********** # 133 **************
PokerStars Hand #214029515834: Tournament #2896837020, $0.98+$0.12 USD Hold'em No Limit - Level XV (350/700) - 2020/05/17 11:51:07 ET
Table '2896837020 159' 9-max Seat #6 is the button
Seat 1: knedy10 (2230 in chips)
Seat 2: 1the_specialone (7592 in chips)
Seat 3: ricster8347 (13576 in chips)
Seat 4: grandpauly (15603 in chips)
Seat 5: elketefuka (20595 in chips)
Seat 6: Rdmulder (22664 in chips)
Seat 7: 13LábúKárlosz (50907 in chips)
Seat 8: shipittosav7 (13274 in chips)
Seat 9: Petey Pop (986 in chips)
knedy10: posts the ante 85
1the_specialone: posts the ante 85
ricster8347: posts the ante 85
grandpauly: posts the ante 85
elketefuka: posts the ante 85
Rdmulder: posts the ante 85
13LábúKárlosz: posts the ante 85
shipittosav7: posts the ante 85
Petey Pop: posts the ante 85
13LábúKárlosz: posts small blind 350
shipittosav7: posts big blind 700
*** HOLE CARDS ***
Dealt to elketefuka [7d 2c]
Petey Pop: folds
knedy10: folds
1the_specialone: folds
ricster8347: folds
grandpauly: folds
elketefuka: folds
Rdmulder: folds
13LábúKárlosz: folds
Uncalled bet (350) returned to shipittosav7
shipittosav7 collected 1465 from pot
shipittosav7: doesn't show hand
*** SUMMARY ***
Total pot 1465 | Rake 0
Seat 1: knedy10 folded before Flop (didn't bet)
Seat 2: 1the_specialone folded before Flop (didn't bet)
Seat 3: ricster8347 folded before Flop (didn't bet)
Seat 4: grandpauly folded before Flop (didn't bet)
Seat 5: elketefuka folded before Flop (didn't bet)
Seat 6: Rdmulder (button) folded before Flop (didn't bet)
Seat 7: 13LábúKárlosz (small blind) folded before Flop
Seat 8: shipittosav7 (big blind) collected (1465)
Seat 9: Petey Pop folded before Flop (didn't bet)


*********** # 134 **************
PokerStars Hand #214029531889: Tournament #2896837020, $0.98+$0.12 USD Hold'em No Limit - Level XV (350/700) - 2020/05/17 11:51:25 ET
Table '2896837020 159' 9-max Seat #7 is the button
Seat 1: knedy10 (2145 in chips)
Seat 2: 1the_specialone (7507 in chips)
Seat 3: ricster8347 (13491 in chips)
Seat 4: grandpauly (15518 in chips)
Seat 5: elketefuka (20510 in chips)
Seat 6: Rdmulder (22579 in chips)
Seat 7: 13LábúKárlosz (50472 in chips)
Seat 8: shipittosav7 (14304 in chips)
Seat 9: Petey Pop (901 in chips)
knedy10: posts the ante 85
1the_specialone: posts the ante 85
ricster8347: posts the ante 85
grandpauly: posts the ante 85
elketefuka: posts the ante 85
Rdmulder: posts the ante 85
13LábúKárlosz: posts the ante 85
shipittosav7: posts the ante 85
Petey Pop: posts the ante 85
shipittosav7: posts small blind 350
Petey Pop: posts big blind 700
*** HOLE CARDS ***
Dealt to elketefuka [4s Kh]
knedy10: folds
1the_specialone: raises 6722 to 7422 and is all-in
ricster8347: folds
grandpauly: folds
elketefuka: folds
Rdmulder: folds
13LábúKárlosz: folds
shipittosav7: folds
Petey Pop: calls 116 and is all-in
Uncalled bet (6606) returned to 1the_specialone
*** FLOP *** [Qc Td Ac]
*** TURN *** [Qc Td Ac] [8h]
*** RIVER *** [Qc Td Ac 8h] [2s]
*** SHOW DOWN ***
Petey Pop: shows [Qs 9d] (a pair of Queens)
1the_specialone: shows [Qh Kc] (a pair of Queens - Ace+King kicker)
1the_specialone collected 2747 from pot
Petey Pop finished the tournament in 567th place and received $1.73.
*** SUMMARY ***
Total pot 2747 | Rake 0
Board [Qc Td Ac 8h 2s]
Seat 1: knedy10 folded before Flop (didn't bet)
Seat 2: 1the_specialone showed [Qh Kc] and won (2747) with a pair of Queens
Seat 3: ricster8347 folded before Flop (didn't bet)
Seat 4: grandpauly folded before Flop (didn't bet)
Seat 5: elketefuka folded before Flop (didn't bet)
Seat 6: Rdmulder folded before Flop (didn't bet)
Seat 7: 13LábúKárlosz (button) folded before Flop (didn't bet)
Seat 8: shipittosav7 (small blind) folded before Flop
Seat 9: Petey Pop (big blind) showed [Qs 9d] and lost with a pair of Queens


*********** # 135 **************
PokerStars Hand #214029556416: Tournament #2896837020, $0.98+$0.12 USD Hold'em No Limit - Level XV (350/700) - 2020/05/17 11:51:52 ET
Table '2896837020 159' 9-max Seat #8 is the button
Seat 1: knedy10 (2060 in chips)
Seat 2: 1the_specialone (9353 in chips)
Seat 3: ricster8347 (13406 in chips)
Seat 4: grandpauly (15433 in chips)
Seat 5: elketefuka (20425 in chips)
Seat 6: Rdmulder (22494 in chips)
Seat 7: 13LábúKárlosz (50387 in chips)
Seat 8: shipittosav7 (13869 in chips)
knedy10: posts the ante 85
1the_specialone: posts the ante 85
ricster8347: posts the ante 85
grandpauly: posts the ante 85
elketefuka: posts the ante 85
Rdmulder: posts the ante 85
13LábúKárlosz: posts the ante 85
shipittosav7: posts the ante 85
knedy10: posts small blind 350
1the_specialone: posts big blind 700
*** HOLE CARDS ***
Dealt to elketefuka [Td 7h]
ricster8347: folds
grandpauly: folds
elketefuka: folds
Rdmulder: folds
13LábúKárlosz: folds
shipittosav7: raises 1001 to 1701
knedy10: folds
1the_specialone: folds
Uncalled bet (1001) returned to shipittosav7
shipittosav7 collected 2430 from pot
shipittosav7: doesn't show hand
*** SUMMARY ***
Total pot 2430 | Rake 0
Seat 1: knedy10 (small blind) folded before Flop
Seat 2: 1the_specialone (big blind) folded before Flop
Seat 3: ricster8347 folded before Flop (didn't bet)
Seat 4: grandpauly folded before Flop (didn't bet)
Seat 5: elketefuka folded before Flop (didn't bet)
Seat 6: Rdmulder folded before Flop (didn't bet)
Seat 7: 13LábúKárlosz folded before Flop (didn't bet)
Seat 8: shipittosav7 (button) collected (2430)


*********** # 136 **************
PokerStars Hand #214029592837: Tournament #2896837020, $0.98+$0.12 USD Hold'em No Limit - Level XV (350/700) - 2020/05/17 11:52:22 ET
Table '2896837020 159' 9-max Seat #1 is the button
Seat 1: knedy10 (1625 in chips)
Seat 2: 1the_specialone (8568 in chips)
Seat 3: ricster8347 (13321 in chips)
Seat 4: grandpauly (15348 in chips)
Seat 5: elketefuka (20340 in chips)
Seat 6: Rdmulder (22409 in chips)
Seat 7: 13LábúKárlosz (50302 in chips)
Seat 8: shipittosav7 (15514 in chips)
knedy10: posts the ante 85
1the_specialone: posts the ante 85
ricster8347: posts the ante 85
grandpauly: posts the ante 85
elketefuka: posts the ante 85
Rdmulder: posts the ante 85
13LábúKárlosz: posts the ante 85
shipittosav7: posts the ante 85
1the_specialone: posts small blind 350
ricster8347: posts big blind 700
*** HOLE CARDS ***
Dealt to elketefuka [9h Qd]
grandpauly: folds
elketefuka: folds
Rdmulder: folds
13LábúKárlosz: folds
shipittosav7: folds
knedy10: folds
1the_specialone: folds
Uncalled bet (350) returned to ricster8347
ricster8347 collected 1380 from pot
ricster8347: doesn't show hand
*** SUMMARY ***
Total pot 1380 | Rake 0
Seat 1: knedy10 (button) folded before Flop (didn't bet)
Seat 2: 1the_specialone (small blind) folded before Flop
Seat 3: ricster8347 (big blind) collected (1380)
Seat 4: grandpauly folded before Flop (didn't bet)
Seat 5: elketefuka folded before Flop (didn't bet)
Seat 6: Rdmulder folded before Flop (didn't bet)
Seat 7: 13LábúKárlosz folded before Flop (didn't bet)
Seat 8: shipittosav7 folded before Flop (didn't bet)


*********** # 137 **************
PokerStars Hand #214029613546: Tournament #2896837020, $0.98+$0.12 USD Hold'em No Limit - Level XV (350/700) - 2020/05/17 11:52:45 ET
Table '2896837020 159' 9-max Seat #2 is the button
Seat 1: knedy10 (1540 in chips)
Seat 2: 1the_specialone (8133 in chips)
Seat 3: ricster8347 (14266 in chips)
Seat 4: grandpauly (15263 in chips)
Seat 5: elketefuka (20255 in chips)
Seat 6: Rdmulder (22324 in chips)
Seat 7: 13LábúKárlosz (50217 in chips)
Seat 8: shipittosav7 (15429 in chips)
Seat 9: sundsundsund (4347 in chips)
knedy10: posts the ante 85
1the_specialone: posts the ante 85
ricster8347: posts the ante 85
grandpauly: posts the ante 85
elketefuka: posts the ante 85
Rdmulder: posts the ante 85
13LábúKárlosz: posts the ante 85
shipittosav7: posts the ante 85
sundsundsund: posts the ante 85
ricster8347: posts small blind 350
grandpauly: posts big blind 700
*** HOLE CARDS ***
Dealt to elketefuka [Ah 4d]
elketefuka: raises 700 to 1400
Rdmulder: folds
13LábúKárlosz: calls 1400
shipittosav7: folds
sundsundsund: folds
knedy10: folds
1the_specialone: folds
ricster8347: folds
grandpauly: calls 700
*** FLOP *** [5s Kd Js]
grandpauly: checks
elketefuka: checks
13LábúKárlosz: checks
*** TURN *** [5s Kd Js] [Qc]
grandpauly: checks
elketefuka: bets 2800
13LábúKárlosz: raises 9450 to 12250
grandpauly: folds
elketefuka: folds
Uncalled bet (9450) returned to 13LábúKárlosz
13LábúKárlosz collected 10915 from pot
13LábúKárlosz: doesn't show hand
*** SUMMARY ***
Total pot 10915 | Rake 0
Board [5s Kd Js Qc]
Seat 1: knedy10 folded before Flop (didn't bet)
Seat 2: 1the_specialone (button) folded before Flop (didn't bet)
Seat 3: ricster8347 (small blind) folded before Flop
Seat 4: grandpauly (big blind) folded on the Turn
Seat 5: elketefuka folded on the Turn
Seat 6: Rdmulder folded before Flop (didn't bet)
Seat 7: 13LábúKárlosz collected (10915)
Seat 8: shipittosav7 folded before Flop (didn't bet)
Seat 9: sundsundsund folded before Flop (didn't bet)


*********** # 138 **************
PokerStars Hand #214029684617: Tournament #2896837020, $0.98+$0.12 USD Hold'em No Limit - Level XV (350/700) - 2020/05/17 11:54:05 ET
Table '2896837020 159' 9-max Seat #3 is the button
Seat 1: knedy10 (1455 in chips)
Seat 2: 1the_specialone (8048 in chips)
Seat 3: ricster8347 (13831 in chips)
Seat 4: grandpauly (13778 in chips)
Seat 5: elketefuka (15970 in chips)
Seat 6: Rdmulder (22239 in chips)
Seat 7: 13LábúKárlosz (56847 in chips)
Seat 8: shipittosav7 (15344 in chips)
Seat 9: sundsundsund (4262 in chips)
knedy10: posts the ante 85
1the_specialone: posts the ante 85
ricster8347: posts the ante 85
grandpauly: posts the ante 85
elketefuka: posts the ante 85
Rdmulder: posts the ante 85
13LábúKárlosz: posts the ante 85
shipittosav7: posts the ante 85
sundsundsund: posts the ante 85
grandpauly: posts small blind 350
elketefuka: posts big blind 700
*** HOLE CARDS ***
Dealt to elketefuka [6c 9h]
Rdmulder: folds
13LábúKárlosz: raises 700 to 1400
shipittosav7: folds
sundsundsund: raises 2777 to 4177 and is all-in
knedy10: calls 1370 and is all-in
1the_specialone: folds
ricster8347: folds
grandpauly: folds
elketefuka: folds
13LábúKárlosz: calls 2777
*** FLOP *** [4d Tc 3s]
*** TURN *** [4d Tc 3s] [Jd]
*** RIVER *** [4d Tc 3s Jd] [7h]
*** SHOW DOWN ***
13LábúKárlosz: shows [9s Ts] (a pair of Tens)
sundsundsund: shows [8c 7c] (a pair of Sevens)
13LábúKárlosz collected 5614 from side pot
knedy10: shows [Kd 8h] (high card King)
13LábúKárlosz collected 5925 from main pot
sundsundsund finished the tournament in 525th place and received $1.73.
knedy10 finished the tournament in 526th place and received $1.73.
*** SUMMARY ***
Total pot 11539 Main pot 5925. Side pot 5614. | Rake 0
Board [4d Tc 3s Jd 7h]
Seat 1: knedy10 showed [Kd 8h] and lost with high card King
Seat 2: 1the_specialone folded before Flop (didn't bet)
Seat 3: ricster8347 (button) folded before Flop (didn't bet)
Seat 4: grandpauly (small blind) folded before Flop
Seat 5: elketefuka (big blind) folded before Flop
Seat 6: Rdmulder folded before Flop (didn't bet)
Seat 7: 13LábúKárlosz showed [9s Ts] and won (11539) with a pair of Tens
Seat 8: shipittosav7 folded before Flop (didn't bet)
Seat 9: sundsundsund showed [8c 7c] and lost with a pair of Sevens


*********** # 139 **************
PokerStars Hand #214029722714: Tournament #2896837020, $0.98+$0.12 USD Hold'em No Limit - Level XV (350/700) - 2020/05/17 11:54:47 ET
Table '2896837020 159' 9-max Seat #4 is the button
Seat 2: 1the_specialone (7963 in chips)
Seat 3: ricster8347 (13746 in chips)
Seat 4: grandpauly (13343 in chips)
Seat 5: elketefuka (15185 in chips)
Seat 6: Rdmulder (22154 in chips)
Seat 7: 13LábúKárlosz (64124 in chips)
Seat 8: shipittosav7 (15259 in chips)
1the_specialone: posts the ante 85
ricster8347: posts the ante 85
grandpauly: posts the ante 85
elketefuka: posts the ante 85
Rdmulder: posts the ante 85
13LábúKárlosz: posts the ante 85
shipittosav7: posts the ante 85
elketefuka: posts small blind 350
Rdmulder: posts big blind 700
*** HOLE CARDS ***
Dealt to elketefuka [4s Ac]
13LábúKárlosz: folds
shipittosav7: folds
1the_specialone: folds
ricster8347: folds
grandpauly: calls 700
elketefuka: calls 350
Rdmulder: checks
*** FLOP *** [7d 5s Jd]
elketefuka: checks
Rdmulder: checks
grandpauly: bets 1348
elketefuka: folds
Rdmulder: folds
Uncalled bet (1348) returned to grandpauly
grandpauly collected 2695 from pot
*** SUMMARY ***
Total pot 2695 | Rake 0
Board [7d 5s Jd]
Seat 2: 1the_specialone folded before Flop (didn't bet)
Seat 3: ricster8347 folded before Flop (didn't bet)
Seat 4: grandpauly (button) collected (2695)
Seat 5: elketefuka (small blind) folded on the Flop
Seat 6: Rdmulder (big blind) folded on the Flop
Seat 7: 13LábúKárlosz folded before Flop (didn't bet)
Seat 8: shipittosav7 folded before Flop (didn't bet)


*********** # 140 **************
PokerStars Hand #214029970067: Tournament #2896837020, $0.98+$0.12 USD Hold'em No Limit - Level XV (350/700) - 2020/05/17 12:01:17 ET
Table '2896837020 159' 9-max Seat #5 is the button
Seat 1: Avmatos88 (13780 in chips)
Seat 2: 1the_specialone (7878 in chips)
Seat 3: ricster8347 (13661 in chips)
Seat 4: grandpauly (15253 in chips)
Seat 5: elketefuka (14400 in chips)
Seat 6: Rdmulder (21369 in chips)
Seat 7: 13LábúKárlosz (64039 in chips)
Seat 8: shipittosav7 (15174 in chips)
Seat 9: fabiokvd (10340 in chips)
Avmatos88: posts the ante 85
1the_specialone: posts the ante 85
ricster8347: posts the ante 85
grandpauly: posts the ante 85
elketefuka: posts the ante 85
Rdmulder: posts the ante 85
13LábúKárlosz: posts the ante 85
shipittosav7: posts the ante 85
fabiokvd: posts the ante 85
Rdmulder: posts small blind 350
13LábúKárlosz: posts big blind 700
*** HOLE CARDS ***
Dealt to elketefuka [7d 2h]
shipittosav7: folds
fabiokvd: folds
Avmatos88: folds
1the_specialone: folds
ricster8347: folds
grandpauly: calls 700
elketefuka: folds
Rdmulder: calls 350
13LábúKárlosz: checks
*** FLOP *** [6c Th 3d]
Rdmulder: checks
13LábúKárlosz: checks
grandpauly: checks
*** TURN *** [6c Th 3d] [Ah]
Rdmulder: checks
13LábúKárlosz: checks
grandpauly: checks
*** RIVER *** [6c Th 3d Ah] [Ac]
Rdmulder: checks
13LábúKárlosz: bets 2120
grandpauly: folds
Rdmulder: calls 2120
*** SHOW DOWN ***
13LábúKárlosz: shows [4h Jd] (a pair of Aces)
Rdmulder: shows [Tc Qs] (two pair, Aces and Tens)
Rdmulder collected 7105 from pot
*** SUMMARY ***
Total pot 7105 | Rake 0
Board [6c Th 3d Ah Ac]
Seat 1: Avmatos88 folded before Flop (didn't bet)
Seat 2: 1the_specialone folded before Flop (didn't bet)
Seat 3: ricster8347 folded before Flop (didn't bet)
Seat 4: grandpauly folded on the River
Seat 5: elketefuka (button) folded before Flop (didn't bet)
Seat 6: Rdmulder (small blind) showed [Tc Qs] and won (7105) with two pair, Aces and Tens
Seat 7: 13LábúKárlosz (big blind) showed [4h Jd] and lost with a pair of Aces
Seat 8: shipittosav7 folded before Flop (didn't bet)
Seat 9: fabiokvd folded before Flop (didn't bet)


*********** # 141 **************
PokerStars Hand #214030047592: Tournament #2896837020, $0.98+$0.12 USD Hold'em No Limit - Level XV (350/700) - 2020/05/17 12:02:50 ET
Table '2896837020 159' 9-max Seat #6 is the button
Seat 1: Avmatos88 (13695 in chips)
Seat 2: 1the_specialone (7793 in chips)
Seat 3: ricster8347 (13576 in chips)
Seat 4: grandpauly (14468 in chips)
Seat 5: elketefuka (14315 in chips)
Seat 6: Rdmulder (25569 in chips)
Seat 7: 13LábúKárlosz (61134 in chips)
Seat 8: shipittosav7 (15089 in chips)
Seat 9: fabiokvd (10255 in chips)
Avmatos88: posts the ante 85
1the_specialone: posts the ante 85
ricster8347: posts the ante 85
grandpauly: posts the ante 85
elketefuka: posts the ante 85
Rdmulder: posts the ante 85
13LábúKárlosz: posts the ante 85
shipittosav7: posts the ante 85
fabiokvd: posts the ante 85
13LábúKárlosz: posts small blind 350
shipittosav7: posts big blind 700
*** HOLE CARDS ***
Dealt to elketefuka [4h Qs]
fabiokvd: folds
Avmatos88: folds
1the_specialone: folds
ricster8347: folds
grandpauly: folds
elketefuka: folds
Rdmulder: raises 840 to 1540
13LábúKárlosz: raises 3010 to 4550
shipittosav7: folds
Rdmulder: calls 3010
*** FLOP *** [8s 9h 7s]
13LábúKárlosz: bets 5250
Rdmulder: calls 5250
*** TURN *** [8s 9h 7s] [3d]
13LábúKárlosz: bets 11796
Rdmulder: folds
Uncalled bet (11796) returned to 13LábúKárlosz
13LábúKárlosz collected 21065 from pot
13LábúKárlosz: doesn't show hand
*** SUMMARY ***
Total pot 21065 | Rake 0
Board [8s 9h 7s 3d]
Seat 1: Avmatos88 folded before Flop (didn't bet)
Seat 2: 1the_specialone folded before Flop (didn't bet)
Seat 3: ricster8347 folded before Flop (didn't bet)
Seat 4: grandpauly folded before Flop (didn't bet)
Seat 5: elketefuka folded before Flop (didn't bet)
Seat 6: Rdmulder (button) folded on the Turn
Seat 7: 13LábúKárlosz (small blind) collected (21065)
Seat 8: shipittosav7 (big blind) folded before Flop
Seat 9: fabiokvd folded before Flop (didn't bet)


*********** # 142 **************
PokerStars Hand #214030116551: Tournament #2896837020, $0.98+$0.12 USD Hold'em No Limit - Level XV (350/700) - 2020/05/17 12:04:06 ET
Table '2896837020 159' 9-max Seat #7 is the button
Seat 1: Avmatos88 (13610 in chips)
Seat 2: 1the_specialone (7708 in chips)
Seat 3: ricster8347 (13491 in chips)
Seat 4: grandpauly (14383 in chips)
Seat 5: elketefuka (14230 in chips)
Seat 6: Rdmulder (15684 in chips)
Seat 7: 13LábúKárlosz (72314 in chips)
Seat 8: shipittosav7 (14304 in chips)
Seat 9: fabiokvd (10170 in chips)
Avmatos88: posts the ante 85
1the_specialone: posts the ante 85
ricster8347: posts the ante 85
grandpauly: posts the ante 85
elketefuka: posts the ante 85
Rdmulder: posts the ante 85
13LábúKárlosz: posts the ante 85
shipittosav7: posts the ante 85
fabiokvd: posts the ante 85
shipittosav7: posts small blind 350
fabiokvd: posts big blind 700
*** HOLE CARDS ***
Dealt to elketefuka [Kh 3d]
Avmatos88: folds
1the_specialone: raises 6923 to 7623 and is all-in
ricster8347: folds
grandpauly: folds
elketefuka: folds
Rdmulder: folds
13LábúKárlosz: folds
shipittosav7: folds
fabiokvd: folds
Uncalled bet (6923) returned to 1the_specialone
1the_specialone collected 2515 from pot
1the_specialone: doesn't show hand
*** SUMMARY ***
Total pot 2515 | Rake 0
Seat 1: Avmatos88 folded before Flop (didn't bet)
Seat 2: 1the_specialone collected (2515)
Seat 3: ricster8347 folded before Flop (didn't bet)
Seat 4: grandpauly folded before Flop (didn't bet)
Seat 5: elketefuka folded before Flop (didn't bet)
Seat 6: Rdmulder folded before Flop (didn't bet)
Seat 7: 13LábúKárlosz (button) folded before Flop (didn't bet)
Seat 8: shipittosav7 (small blind) folded before Flop
Seat 9: fabiokvd (big blind) folded before Flop


*********** # 143 **************
PokerStars Hand #214030133676: Tournament #2896837020, $0.98+$0.12 USD Hold'em No Limit - Level XV (350/700) - 2020/05/17 12:04:24 ET
Table '2896837020 159' 9-max Seat #8 is the button
Seat 1: Avmatos88 (13525 in chips)
Seat 2: 1the_specialone (9438 in chips)
Seat 3: ricster8347 (13406 in chips)
Seat 4: grandpauly (14298 in chips)
Seat 5: elketefuka (14145 in chips)
Seat 6: Rdmulder (15599 in chips)
Seat 7: 13LábúKárlosz (72229 in chips)
Seat 8: shipittosav7 (13869 in chips)
Seat 9: fabiokvd (9385 in chips)
Avmatos88: posts the ante 85
1the_specialone: posts the ante 85
ricster8347: posts the ante 85
grandpauly: posts the ante 85
elketefuka: posts the ante 85
Rdmulder: posts the ante 85
13LábúKárlosz: posts the ante 85
shipittosav7: posts the ante 85
fabiokvd: posts the ante 85
fabiokvd: posts small blind 350
Avmatos88: posts big blind 700
*** HOLE CARDS ***
Dealt to elketefuka [3h 8s]
1the_specialone: folds
ricster8347: folds
grandpauly: folds
elketefuka: folds
Rdmulder: folds
13LábúKárlosz: raises 1050 to 1750
shipittosav7: folds
fabiokvd: folds
Avmatos88: calls 1050
*** FLOP *** [Ah 6c 4c]
Avmatos88: checks
13LábúKárlosz: bets 2584
Avmatos88: folds
Uncalled bet (2584) returned to 13LábúKárlosz
13LábúKárlosz collected 4615 from pot
13LábúKárlosz: doesn't show hand
*** SUMMARY ***
Total pot 4615 | Rake 0
Board [Ah 6c 4c]
Seat 1: Avmatos88 (big blind) folded on the Flop
Seat 2: 1the_specialone folded before Flop (didn't bet)
Seat 3: ricster8347 folded before Flop (didn't bet)
Seat 4: grandpauly folded before Flop (didn't bet)
Seat 5: elketefuka folded before Flop (didn't bet)
Seat 6: Rdmulder folded before Flop (didn't bet)
Seat 7: 13LábúKárlosz collected (4615)
Seat 8: shipittosav7 (button) folded before Flop (didn't bet)
Seat 9: fabiokvd (small blind) folded before Flop


*********** # 144 **************
PokerStars Hand #214030192917: Tournament #2896837020, $0.98+$0.12 USD Hold'em No Limit - Level XVI (400/800) - 2020/05/17 12:05:29 ET
Table '2896837020 159' 9-max Seat #9 is the button
Seat 1: Avmatos88 (11690 in chips)
Seat 2: 1the_specialone (9353 in chips)
Seat 3: ricster8347 (13321 in chips)
Seat 4: grandpauly (14213 in chips)
Seat 5: elketefuka (14060 in chips)
Seat 6: Rdmulder (15514 in chips)
Seat 7: 13LábúKárlosz (75009 in chips)
Seat 8: shipittosav7 (13784 in chips)
Seat 9: fabiokvd (8950 in chips)
Avmatos88: posts the ante 100
1the_specialone: posts the ante 100
ricster8347: posts the ante 100
grandpauly: posts the ante 100
elketefuka: posts the ante 100
Rdmulder: posts the ante 100
13LábúKárlosz: posts the ante 100
shipittosav7: posts the ante 100
fabiokvd: posts the ante 100
Avmatos88: posts small blind 400
1the_specialone: posts big blind 800
*** HOLE CARDS ***
Dealt to elketefuka [8c Td]
ricster8347: folds
grandpauly: raises 800 to 1600
elketefuka: folds
Rdmulder: folds
13LábúKárlosz: folds
shipittosav7: folds
fabiokvd: folds
Avmatos88: folds
1the_specialone: folds
Uncalled bet (800) returned to grandpauly
grandpauly collected 2900 from pot
*** SUMMARY ***
Total pot 2900 | Rake 0
Seat 1: Avmatos88 (small blind) folded before Flop
Seat 2: 1the_specialone (big blind) folded before Flop
Seat 3: ricster8347 folded before Flop (didn't bet)
Seat 4: grandpauly collected (2900)
Seat 5: elketefuka folded before Flop (didn't bet)
Seat 6: Rdmulder folded before Flop (didn't bet)
Seat 7: 13LábúKárlosz folded before Flop (didn't bet)
Seat 8: shipittosav7 folded before Flop (didn't bet)
Seat 9: fabiokvd (button) folded before Flop (didn't bet)


*********** # 145 **************
PokerStars Hand #214030207987: Tournament #2896837020, $0.98+$0.12 USD Hold'em No Limit - Level XVI (400/800) - 2020/05/17 12:05:45 ET
Table '2896837020 159' 9-max Seat #1 is the button
Seat 1: Avmatos88 (11190 in chips)
Seat 2: 1the_specialone (8453 in chips)
Seat 3: ricster8347 (13221 in chips)
Seat 4: grandpauly (16213 in chips)
Seat 5: elketefuka (13960 in chips)
Seat 6: Rdmulder (15414 in chips)
Seat 7: 13LábúKárlosz (74909 in chips)
Seat 8: shipittosav7 (13684 in chips)
Seat 9: fabiokvd (8850 in chips)
Avmatos88: posts the ante 100
1the_specialone: posts the ante 100
ricster8347: posts the ante 100
grandpauly: posts the ante 100
elketefuka: posts the ante 100
Rdmulder: posts the ante 100
13LábúKárlosz: posts the ante 100
shipittosav7: posts the ante 100
fabiokvd: posts the ante 100
1the_specialone: posts small blind 400
ricster8347: posts big blind 800
*** HOLE CARDS ***
Dealt to elketefuka [4c Qs]
grandpauly: folds
elketefuka: folds
Rdmulder: folds
13LábúKárlosz: folds
shipittosav7: folds
fabiokvd: folds
Avmatos88: folds
1the_specialone: folds
Uncalled bet (400) returned to ricster8347
ricster8347 collected 1700 from pot
ricster8347: doesn't show hand
*** SUMMARY ***
Total pot 1700 | Rake 0
Seat 1: Avmatos88 (button) folded before Flop (didn't bet)
Seat 2: 1the_specialone (small blind) folded before Flop
Seat 3: ricster8347 (big blind) collected (1700)
Seat 4: grandpauly folded before Flop (didn't bet)
Seat 5: elketefuka folded before Flop (didn't bet)
Seat 6: Rdmulder folded before Flop (didn't bet)
Seat 7: 13LábúKárlosz folded before Flop (didn't bet)
Seat 8: shipittosav7 folded before Flop (didn't bet)
Seat 9: fabiokvd folded before Flop (didn't bet)


*********** # 146 **************
PokerStars Hand #214030224639: Tournament #2896837020, $0.98+$0.12 USD Hold'em No Limit - Level XVI (400/800) - 2020/05/17 12:06:03 ET
Table '2896837020 159' 9-max Seat #2 is the button
Seat 1: Avmatos88 (11090 in chips)
Seat 2: 1the_specialone (7953 in chips)
Seat 3: ricster8347 (14421 in chips)
Seat 4: grandpauly (16113 in chips)
Seat 5: elketefuka (13860 in chips)
Seat 6: Rdmulder (15314 in chips)
Seat 7: 13LábúKárlosz (74809 in chips)
Seat 8: shipittosav7 (13584 in chips)
Seat 9: fabiokvd (8750 in chips)
Avmatos88: posts the ante 100
1the_specialone: posts the ante 100
ricster8347: posts the ante 100
grandpauly: posts the ante 100
elketefuka: posts the ante 100
Rdmulder: posts the ante 100
13LábúKárlosz: posts the ante 100
shipittosav7: posts the ante 100
fabiokvd: posts the ante 100
ricster8347: posts small blind 400
grandpauly: posts big blind 800
*** HOLE CARDS ***
Dealt to elketefuka [3s 7h]
elketefuka: folds
Rdmulder: folds
13LábúKárlosz: folds
shipittosav7: folds
fabiokvd: folds
Avmatos88: folds
1the_specialone: folds
ricster8347: folds
Uncalled bet (400) returned to grandpauly
grandpauly collected 1700 from pot
*** SUMMARY ***
Total pot 1700 | Rake 0
Seat 1: Avmatos88 folded before Flop (didn't bet)
Seat 2: 1the_specialone (button) folded before Flop (didn't bet)
Seat 3: ricster8347 (small blind) folded before Flop
Seat 4: grandpauly (big blind) collected (1700)
Seat 5: elketefuka folded before Flop (didn't bet)
Seat 6: Rdmulder folded before Flop (didn't bet)
Seat 7: 13LábúKárlosz folded before Flop (didn't bet)
Seat 8: shipittosav7 folded before Flop (didn't bet)
Seat 9: fabiokvd folded before Flop (didn't bet)


*********** # 147 **************
PokerStars Hand #214030234848: Tournament #2896837020, $0.98+$0.12 USD Hold'em No Limit - Level XVI (400/800) - 2020/05/17 12:06:14 ET
Table '2896837020 159' 9-max Seat #3 is the button
Seat 1: Avmatos88 (10990 in chips)
Seat 2: 1the_specialone (7853 in chips)
Seat 3: ricster8347 (13921 in chips)
Seat 4: grandpauly (17313 in chips)
Seat 5: elketefuka (13760 in chips)
Seat 6: Rdmulder (15214 in chips)
Seat 7: 13LábúKárlosz (74709 in chips)
Seat 8: shipittosav7 (13484 in chips)
Seat 9: fabiokvd (8650 in chips)
Avmatos88: posts the ante 100
1the_specialone: posts the ante 100
ricster8347: posts the ante 100
grandpauly: posts the ante 100
elketefuka: posts the ante 100
Rdmulder: posts the ante 100
13LábúKárlosz: posts the ante 100
shipittosav7: posts the ante 100
fabiokvd: posts the ante 100
grandpauly: posts small blind 400
elketefuka: posts big blind 800
*** HOLE CARDS ***
Dealt to elketefuka [2c 6c]
Rdmulder: folds
13LábúKárlosz: raises 1200 to 2000
shipittosav7: folds
fabiokvd: folds
Avmatos88: folds
1the_specialone: raises 5753 to 7753 and is all-in
ricster8347: folds
grandpauly: folds
elketefuka: folds
13LábúKárlosz: calls 5753
*** FLOP *** [8s 3c Qh]
*** TURN *** [8s 3c Qh] [6h]
*** RIVER *** [8s 3c Qh 6h] [9c]
*** SHOW DOWN ***
13LábúKárlosz: shows [Tc Jc] (a straight, Eight to Queen)
1the_specialone: shows [Ac Qs] (a pair of Queens)
13LábúKárlosz collected 17606 from pot
1the_specialone finished the tournament in 478th place and received $1.73.
*** SUMMARY ***
Total pot 17606 | Rake 0
Board [8s 3c Qh 6h 9c]
Seat 1: Avmatos88 folded before Flop (didn't bet)
Seat 2: 1the_specialone showed [Ac Qs] and lost with a pair of Queens
Seat 3: ricster8347 (button) folded before Flop (didn't bet)
Seat 4: grandpauly (small blind) folded before Flop
Seat 5: elketefuka (big blind) folded before Flop
Seat 6: Rdmulder folded before Flop (didn't bet)
Seat 7: 13LábúKárlosz showed [Tc Jc] and won (17606) with a straight, Eight to Queen
Seat 8: shipittosav7 folded before Flop (didn't bet)
Seat 9: fabiokvd folded before Flop (didn't bet)


*********** # 148 **************
PokerStars Hand #214030282633: Tournament #2896837020, $0.98+$0.12 USD Hold'em No Limit - Level XVI (400/800) - 2020/05/17 12:07:06 ET
Table '2896837020 52' 9-max Seat #3 is the button
Seat 1: Luan-joaquim (38062 in chips)
Seat 2: Tuca-sp (21851 in chips)
Seat 3: aks932 (11272 in chips)
Seat 4: elketefuka (12860 in chips) out of hand (moved from another table into small blind)
Seat 5: yamudda321 (35700 in chips)
Seat 6: villmaðurin (49631 in chips)
Seat 7: thief19.03.85 (83618 in chips)
Seat 8: TVRMikey (26361 in chips)
Seat 9: rog3543 (11924 in chips)
elketefuka will be allowed to play after the button
Luan-joaquim: posts the ante 100
Tuca-sp: posts the ante 100
aks932: posts the ante 100
yamudda321: posts the ante 100
villmaðurin: posts the ante 100
thief19.03.85: posts the ante 100
TVRMikey: posts the ante 100
rog3543: posts the ante 100
yamudda321: posts small blind 400
villmaðurin: posts big blind 800
*** HOLE CARDS ***
thief19.03.85: folds
TVRMikey: folds
rog3543: folds
Luan-joaquim: folds
Tuca-sp: folds
aks932: folds
yamudda321: calls 400
villmaðurin: checks
*** FLOP *** [Qs 6c 9s]
yamudda321: bets 800
villmaðurin: folds
Uncalled bet (800) returned to yamudda321
yamudda321 collected 2400 from pot
yamudda321: doesn't show hand
*** SUMMARY ***
Total pot 2400 | Rake 0
Board [Qs 6c 9s]
Seat 1: Luan-joaquim folded before Flop (didn't bet)
Seat 2: Tuca-sp folded before Flop (didn't bet)
Seat 3: aks932 (button) folded before Flop (didn't bet)
Seat 5: yamudda321 (small blind) collected (2400)
Seat 6: villmaðurin (big blind) folded on the Flop
Seat 7: thief19.03.85 folded before Flop (didn't bet)
Seat 8: TVRMikey folded before Flop (didn't bet)
Seat 9: rog3543 folded before Flop (didn't bet)


*********** # 149 **************
PokerStars Hand #214030302438: Tournament #2896837020, $0.98+$0.12 USD Hold'em No Limit - Level XVI (400/800) - 2020/05/17 12:07:27 ET
Table '2896837020 52' 9-max Seat #5 is the button
Seat 1: Luan-joaquim (37962 in chips)
Seat 2: Tuca-sp (21751 in chips)
Seat 3: aks932 (11172 in chips)
Seat 4: elketefuka (12860 in chips)
Seat 5: yamudda321 (37200 in chips)
Seat 6: villmaðurin (48731 in chips)
Seat 7: thief19.03.85 (83518 in chips)
Seat 8: TVRMikey (26261 in chips)
Seat 9: rog3543 (11824 in chips)
Luan-joaquim: posts the ante 100
Tuca-sp: posts the ante 100
aks932: posts the ante 100
elketefuka: posts the ante 100
yamudda321: posts the ante 100
villmaðurin: posts the ante 100
thief19.03.85: posts the ante 100
TVRMikey: posts the ante 100
rog3543: posts the ante 100
villmaðurin: posts small blind 400
thief19.03.85: posts big blind 800
*** HOLE CARDS ***
Dealt to elketefuka [4s 6s]
TVRMikey: raises 800 to 1600
rog3543: folds
Luan-joaquim: folds
Tuca-sp: folds
aks932: calls 1600
elketefuka: folds
yamudda321: folds
villmaðurin: folds
thief19.03.85: calls 800
*** FLOP *** [4h 8h 8c]
thief19.03.85: checks
TVRMikey: bets 1600
aks932: folds
thief19.03.85: folds
Uncalled bet (1600) returned to TVRMikey
TVRMikey collected 6100 from pot
TVRMikey: doesn't show hand
*** SUMMARY ***
Total pot 6100 | Rake 0
Board [4h 8h 8c]
Seat 1: Luan-joaquim folded before Flop (didn't bet)
Seat 2: Tuca-sp folded before Flop (didn't bet)
Seat 3: aks932 folded on the Flop
Seat 4: elketefuka folded before Flop (didn't bet)
Seat 5: yamudda321 (button) folded before Flop (didn't bet)
Seat 6: villmaðurin (small blind) folded before Flop
Seat 7: thief19.03.85 (big blind) folded on the Flop
Seat 8: TVRMikey collected (6100)
Seat 9: rog3543 folded before Flop (didn't bet)


*********** # 150 **************
PokerStars Hand #214030334915: Tournament #2896837020, $0.98+$0.12 USD Hold'em No Limit - Level XVI (400/800) - 2020/05/17 12:08:03 ET
Table '2896837020 52' 9-max Seat #6 is the button
Seat 1: Luan-joaquim (37862 in chips)
Seat 2: Tuca-sp (21651 in chips)
Seat 3: aks932 (9472 in chips)
Seat 4: elketefuka (12760 in chips)
Seat 5: yamudda321 (37100 in chips)
Seat 6: villmaðurin (48231 in chips)
Seat 7: thief19.03.85 (81818 in chips)
Seat 8: TVRMikey (30661 in chips)
Seat 9: rog3543 (11724 in chips)
Luan-joaquim: posts the ante 100
Tuca-sp: posts the ante 100
aks932: posts the ante 100
elketefuka: posts the ante 100
yamudda321: posts the ante 100
villmaðurin: posts the ante 100
thief19.03.85: posts the ante 100
TVRMikey: posts the ante 100
rog3543: posts the ante 100
thief19.03.85: posts small blind 400
TVRMikey: posts big blind 800
*** HOLE CARDS ***
Dealt to elketefuka [4d 2d]
rog3543: folds
Luan-joaquim: folds
Tuca-sp: folds
aks932: folds
elketefuka: folds
yamudda321: calls 800
villmaðurin: folds
thief19.03.85: calls 400
TVRMikey: checks
*** FLOP *** [Ah 5d Td]
thief19.03.85: checks
TVRMikey: checks
yamudda321: checks
*** TURN *** [Ah 5d Td] [5c]
thief19.03.85: checks
TVRMikey: bets 800
yamudda321: calls 800
thief19.03.85: calls 800
*** RIVER *** [Ah 5d Td 5c] [2h]
thief19.03.85: checks
TVRMikey: bets 800
yamudda321: folds
thief19.03.85: calls 800
*** SHOW DOWN ***
TVRMikey: shows [Ts Qd] (two pair, Tens and Fives)
thief19.03.85: mucks hand
TVRMikey collected 7300 from pot
*** SUMMARY ***
Total pot 7300 | Rake 0
Board [Ah 5d Td 5c 2h]
Seat 1: Luan-joaquim folded before Flop (didn't bet)
Seat 2: Tuca-sp folded before Flop (didn't bet)
Seat 3: aks932 folded before Flop (didn't bet)
Seat 4: elketefuka folded before Flop (didn't bet)
Seat 5: yamudda321 folded on the River
Seat 6: villmaðurin (button) folded before Flop (didn't bet)
Seat 7: thief19.03.85 (small blind) mucked [8s Kh]
Seat 8: TVRMikey (big blind) showed [Ts Qd] and won (7300) with two pair, Tens and Fives
Seat 9: rog3543 folded before Flop (didn't bet)


*********** # 151 **************
PokerStars Hand #214030377612: Tournament #2896837020, $0.98+$0.12 USD Hold'em No Limit - Level XVI (400/800) - 2020/05/17 12:08:50 ET
Table '2896837020 52' 9-max Seat #7 is the button
Seat 1: Luan-joaquim (37762 in chips)
Seat 2: Tuca-sp (21551 in chips)
Seat 3: aks932 (9372 in chips)
Seat 4: elketefuka (12660 in chips)
Seat 5: yamudda321 (35400 in chips)
Seat 6: villmaðurin (48131 in chips)
Seat 7: thief19.03.85 (79318 in chips)
Seat 8: TVRMikey (35461 in chips)
Seat 9: rog3543 (11624 in chips)
Luan-joaquim: posts the ante 100
Tuca-sp: posts the ante 100
aks932: posts the ante 100
elketefuka: posts the ante 100
yamudda321: posts the ante 100
villmaðurin: posts the ante 100
thief19.03.85: posts the ante 100
TVRMikey: posts the ante 100
rog3543: posts the ante 100
TVRMikey: posts small blind 400
rog3543: posts big blind 800
*** HOLE CARDS ***
Dealt to elketefuka [Ac 2c]
Luan-joaquim: raises 800 to 1600
Tuca-sp: folds
aks932: folds
elketefuka: raises 10960 to 12560 and is all-in
yamudda321: folds
villmaðurin: raises 10960 to 23520
thief19.03.85: calls 23520
TVRMikey: folds
rog3543: folds
Luan-joaquim: folds
*** FLOP *** [Kc Ts Td]
villmaðurin: checks
thief19.03.85: checks
*** TURN *** [Kc Ts Td] [7d]
villmaðurin: checks
thief19.03.85: checks
*** RIVER *** [Kc Ts Td 7d] [9d]
villmaðurin: checks
thief19.03.85: checks
*** SHOW DOWN ***
villmaðurin: shows [6c 4s] (a pair of Tens)
thief19.03.85: shows [As 2h] (a pair of Tens - Ace kicker)
thief19.03.85 collected 21920 from side pot
elketefuka: shows [Ac 2c] (a pair of Tens)
elketefuka collected 20690 from main pot
thief19.03.85 collected 20690 from main pot
*** SUMMARY ***
Total pot 63300 Main pot 41380. Side pot 21920. | Rake 0
Board [Kc Ts Td 7d 9d]
Seat 1: Luan-joaquim folded before Flop
Seat 2: Tuca-sp folded before Flop (didn't bet)
Seat 3: aks932 folded before Flop (didn't bet)
Seat 4: elketefuka showed [Ac 2c] and won (20690) with a pair of Tens
Seat 5: yamudda321 folded before Flop (didn't bet)
Seat 6: villmaðurin showed [6c 4s] and lost with a pair of Tens
Seat 7: thief19.03.85 (button) showed [As 2h] and won (42610) with a pair of Tens
Seat 8: TVRMikey (small blind) folded before Flop
Seat 9: rog3543 (big blind) folded before Flop


*********** # 152 **************
PokerStars Hand #214030413281: Tournament #2896837020, $0.98+$0.12 USD Hold'em No Limit - Level XVI (400/800) - 2020/05/17 12:09:28 ET
Table '2896837020 52' 9-max Seat #8 is the button
Seat 1: Luan-joaquim (36062 in chips)
Seat 2: Tuca-sp (21451 in chips)
Seat 3: aks932 (9272 in chips)
Seat 4: elketefuka (20690 in chips)
Seat 5: yamudda321 (35300 in chips)
Seat 6: villmaðurin (24511 in chips)
Seat 7: thief19.03.85 (98308 in chips)
Seat 8: TVRMikey (34961 in chips)
Seat 9: rog3543 (10724 in chips)
Luan-joaquim: posts the ante 100
Tuca-sp: posts the ante 100
aks932: posts the ante 100
elketefuka: posts the ante 100
yamudda321: posts the ante 100
villmaðurin: posts the ante 100
thief19.03.85: posts the ante 100
TVRMikey: posts the ante 100
rog3543: posts the ante 100
rog3543: posts small blind 400
Luan-joaquim: posts big blind 800
*** HOLE CARDS ***
Dealt to elketefuka [6s 8c]
Tuca-sp: folds
aks932: calls 800
elketefuka: folds
yamudda321: folds
villmaðurin: folds
thief19.03.85: folds
TVRMikey: folds
rog3543: folds
Luan-joaquim: checks
*** FLOP *** [Kd 8d Js]
Luan-joaquim: checks
aks932: checks
*** TURN *** [Kd 8d Js] [Th]
Luan-joaquim: checks
aks932: bets 2900
Luan-joaquim: folds
Uncalled bet (2900) returned to aks932
aks932 collected 2900 from pot
aks932: doesn't show hand
*** SUMMARY ***
Total pot 2900 | Rake 0
Board [Kd 8d Js Th]
Seat 1: Luan-joaquim (big blind) folded on the Turn
Seat 2: Tuca-sp folded before Flop (didn't bet)
Seat 3: aks932 collected (2900)
Seat 4: elketefuka folded before Flop (didn't bet)
Seat 5: yamudda321 folded before Flop (didn't bet)
Seat 6: villmaðurin folded before Flop (didn't bet)
Seat 7: thief19.03.85 folded before Flop (didn't bet)
Seat 8: TVRMikey (button) folded before Flop (didn't bet)
Seat 9: rog3543 (small blind) folded before Flop


*********** # 153 **************
PokerStars Hand #214030452447: Tournament #2896837020, $0.98+$0.12 USD Hold'em No Limit - Level XVI (400/800) - 2020/05/17 12:10:11 ET
Table '2896837020 52' 9-max Seat #9 is the button
Seat 1: Luan-joaquim (35162 in chips)
Seat 2: Tuca-sp (21351 in chips)
Seat 3: aks932 (11272 in chips)
Seat 4: elketefuka (20590 in chips)
Seat 5: yamudda321 (35200 in chips)
Seat 6: villmaðurin (24411 in chips)
Seat 7: thief19.03.85 (98208 in chips)
Seat 8: TVRMikey (34861 in chips)
Seat 9: rog3543 (10224 in chips)
Luan-joaquim: posts the ante 100
Tuca-sp: posts the ante 100
aks932: posts the ante 100
elketefuka: posts the ante 100
yamudda321: posts the ante 100
villmaðurin: posts the ante 100
thief19.03.85: posts the ante 100
TVRMikey: posts the ante 100
rog3543: posts the ante 100
Luan-joaquim: posts small blind 400
Tuca-sp: posts big blind 800
*** HOLE CARDS ***
Dealt to elketefuka [8d Kh]
aks932: folds
elketefuka: folds
yamudda321: folds
villmaðurin: folds
thief19.03.85: folds
TVRMikey: raises 800 to 1600
rog3543: folds
Luan-joaquim: folds
Tuca-sp: folds
Uncalled bet (800) returned to TVRMikey
TVRMikey collected 2900 from pot
TVRMikey: doesn't show hand
*** SUMMARY ***
Total pot 2900 | Rake 0
Seat 1: Luan-joaquim (small blind) folded before Flop
Seat 2: Tuca-sp (big blind) folded before Flop
Seat 3: aks932 folded before Flop (didn't bet)
Seat 4: elketefuka folded before Flop (didn't bet)
Seat 5: yamudda321 folded before Flop (didn't bet)
Seat 6: villmaðurin folded before Flop (didn't bet)
Seat 7: thief19.03.85 folded before Flop (didn't bet)
Seat 8: TVRMikey collected (2900)
Seat 9: rog3543 (button) folded before Flop (didn't bet)


*********** # 154 **************
PokerStars Hand #214030478629: Tournament #2896837020, $0.98+$0.12 USD Hold'em No Limit - Level XVI (400/800) - 2020/05/17 12:10:39 ET
Table '2896837020 52' 9-max Seat #1 is the button
Seat 1: Luan-joaquim (34662 in chips)
Seat 2: Tuca-sp (20451 in chips)
Seat 3: aks932 (11172 in chips)
Seat 4: elketefuka (20490 in chips)
Seat 5: yamudda321 (35100 in chips)
Seat 6: villmaðurin (24311 in chips)
Seat 7: thief19.03.85 (98108 in chips)
Seat 8: TVRMikey (36861 in chips)
Seat 9: rog3543 (10124 in chips)
Luan-joaquim: posts the ante 100
Tuca-sp: posts the ante 100
aks932: posts the ante 100
elketefuka: posts the ante 100
yamudda321: posts the ante 100
villmaðurin: posts the ante 100
thief19.03.85: posts the ante 100
TVRMikey: posts the ante 100
rog3543: posts the ante 100
Tuca-sp: posts small blind 400
aks932: posts big blind 800
*** HOLE CARDS ***
Dealt to elketefuka [Ah Kd]
elketefuka: raises 2400 to 3200
yamudda321: folds
villmaðurin: folds
thief19.03.85: folds
TVRMikey: folds
rog3543: folds
Luan-joaquim: folds
Tuca-sp: folds
aks932: folds
Uncalled bet (2400) returned to elketefuka
elketefuka collected 2900 from pot
elketefuka: doesn't show hand
*** SUMMARY ***
Total pot 2900 | Rake 0
Seat 1: Luan-joaquim (button) folded before Flop (didn't bet)
Seat 2: Tuca-sp (small blind) folded before Flop
Seat 3: aks932 (big blind) folded before Flop
Seat 4: elketefuka collected (2900)
Seat 5: yamudda321 folded before Flop (didn't bet)
Seat 6: villmaðurin folded before Flop (didn't bet)
Seat 7: thief19.03.85 folded before Flop (didn't bet)
Seat 8: TVRMikey folded before Flop (didn't bet)
Seat 9: rog3543 folded before Flop (didn't bet)


*********** # 155 **************
PokerStars Hand #214030515663: Tournament #2896837020, $0.98+$0.12 USD Hold'em No Limit - Level XVI (400/800) - 2020/05/17 12:11:19 ET
Table '2896837020 52' 9-max Seat #2 is the button
Seat 1: Luan-joaquim (34562 in chips)
Seat 2: Tuca-sp (19951 in chips)
Seat 3: aks932 (10272 in chips)
Seat 4: elketefuka (22490 in chips)
Seat 5: yamudda321 (35000 in chips)
Seat 6: villmaðurin (24211 in chips)
Seat 7: thief19.03.85 (98008 in chips)
Seat 8: TVRMikey (36761 in chips)
Seat 9: rog3543 (10024 in chips)
Luan-joaquim: posts the ante 100
Tuca-sp: posts the ante 100
aks932: posts the ante 100
elketefuka: posts the ante 100
yamudda321: posts the ante 100
villmaðurin: posts the ante 100
thief19.03.85: posts the ante 100
TVRMikey: posts the ante 100
rog3543: posts the ante 100
aks932: posts small blind 400
elketefuka: posts big blind 800
*** HOLE CARDS ***
Dealt to elketefuka [Kd 9c]
yamudda321: folds
villmaðurin: folds
thief19.03.85: folds
TVRMikey: folds
rog3543: raises 9124 to 9924 and is all-in
Luan-joaquim: folds
Tuca-sp: folds
aks932: folds
elketefuka: folds
Uncalled bet (9124) returned to rog3543
rog3543 collected 2900 from pot
rog3543: doesn't show hand
*** SUMMARY ***
Total pot 2900 | Rake 0
Seat 1: Luan-joaquim folded before Flop (didn't bet)
Seat 2: Tuca-sp (button) folded before Flop (didn't bet)
Seat 3: aks932 (small blind) folded before Flop
Seat 4: elketefuka (big blind) folded before Flop
Seat 5: yamudda321 folded before Flop (didn't bet)
Seat 6: villmaðurin folded before Flop (didn't bet)
Seat 7: thief19.03.85 folded before Flop (didn't bet)
Seat 8: TVRMikey folded before Flop (didn't bet)
Seat 9: rog3543 collected (2900)


*********** # 156 **************
PokerStars Hand #214030534201: Tournament #2896837020, $0.98+$0.12 USD Hold'em No Limit - Level XVI (400/800) - 2020/05/17 12:11:39 ET
Table '2896837020 52' 9-max Seat #3 is the button
Seat 1: Luan-joaquim (34462 in chips)
Seat 2: Tuca-sp (19851 in chips)
Seat 3: aks932 (9772 in chips)
Seat 4: elketefuka (21590 in chips)
Seat 5: yamudda321 (34900 in chips)
Seat 6: villmaðurin (24111 in chips)
Seat 7: thief19.03.85 (97908 in chips)
Seat 8: TVRMikey (36661 in chips)
Seat 9: rog3543 (12024 in chips)
Luan-joaquim: posts the ante 100
Tuca-sp: posts the ante 100
aks932: posts the ante 100
elketefuka: posts the ante 100
yamudda321: posts the ante 100
villmaðurin: posts the ante 100
thief19.03.85: posts the ante 100
TVRMikey: posts the ante 100
rog3543: posts the ante 100
elketefuka: posts small blind 400
yamudda321: posts big blind 800
*** HOLE CARDS ***
Dealt to elketefuka [As 6d]
villmaðurin: folds
thief19.03.85: calls 800
TVRMikey: folds
rog3543: folds
Luan-joaquim: folds
Tuca-sp: folds
aks932: folds
elketefuka: calls 400
yamudda321: checks
*** FLOP *** [8h 3c 6h]
elketefuka: checks
yamudda321: checks
thief19.03.85: bets 1600
elketefuka: calls 1600
yamudda321: folds
*** TURN *** [8h 3c 6h] [Kd]
elketefuka: checks
thief19.03.85: bets 1600
elketefuka: calls 1600
*** RIVER *** [8h 3c 6h Kd] [2d]
elketefuka: bets 17490 and is all-in
thief19.03.85: folds
Uncalled bet (17490) returned to elketefuka
elketefuka collected 9700 from pot
elketefuka: doesn't show hand
*** SUMMARY ***
Total pot 9700 | Rake 0
Board [8h 3c 6h Kd 2d]
Seat 1: Luan-joaquim folded before Flop (didn't bet)
Seat 2: Tuca-sp folded before Flop (didn't bet)
Seat 3: aks932 (button) folded before Flop (didn't bet)
Seat 4: elketefuka (small blind) collected (9700)
Seat 5: yamudda321 (big blind) folded on the Flop
Seat 6: villmaðurin folded before Flop (didn't bet)
Seat 7: thief19.03.85 folded on the River
Seat 8: TVRMikey folded before Flop (didn't bet)
Seat 9: rog3543 folded before Flop (didn't bet)


*********** # 157 **************
PokerStars Hand #214030584111: Tournament #2896837020, $0.98+$0.12 USD Hold'em No Limit - Level XVI (400/800) - 2020/05/17 12:12:33 ET
Table '2896837020 52' 9-max Seat #4 is the button
Seat 1: Luan-joaquim (34362 in chips)
Seat 2: Tuca-sp (19751 in chips)
Seat 3: aks932 (9672 in chips)
Seat 4: elketefuka (27190 in chips)
Seat 5: yamudda321 (34000 in chips)
Seat 6: villmaðurin (24011 in chips)
Seat 7: thief19.03.85 (93808 in chips)
Seat 8: TVRMikey (36561 in chips)
Seat 9: rog3543 (11924 in chips)
Luan-joaquim: posts the ante 100
Tuca-sp: posts the ante 100
aks932: posts the ante 100
elketefuka: posts the ante 100
yamudda321: posts the ante 100
villmaðurin: posts the ante 100
thief19.03.85: posts the ante 100
TVRMikey: posts the ante 100
rog3543: posts the ante 100
yamudda321: posts small blind 400
villmaðurin: posts big blind 800
*** HOLE CARDS ***
Dealt to elketefuka [4c 5c]
thief19.03.85: raises 800 to 1600
TVRMikey: calls 1600
rog3543: folds
Luan-joaquim: folds
Tuca-sp: folds
aks932: folds
elketefuka: calls 1600
yamudda321: folds
villmaðurin: folds
*** FLOP *** [6h Qd 7d]
thief19.03.85: checks
TVRMikey: checks
elketefuka: bets 3200
thief19.03.85: calls 3200
TVRMikey: folds
*** TURN *** [6h Qd 7d] [9d]
thief19.03.85: checks
elketefuka: bets 4800
thief19.03.85: calls 4800
*** RIVER *** [6h Qd 7d 9d] [Qs]
thief19.03.85: checks
elketefuka: bets 17490 and is all-in
thief19.03.85: calls 17490
*** SHOW DOWN ***
elketefuka: shows [4c 5c] (a pair of Queens)
thief19.03.85: shows [Ah As] (two pair, Aces and Queens)
thief19.03.85 collected 57880 from pot
elketefuka finished the tournament in 434th place and received $2.43.
*** SUMMARY ***
Total pot 57880 | Rake 0
Board [6h Qd 7d 9d Qs]
Seat 1: Luan-joaquim folded before Flop (didn't bet)
Seat 2: Tuca-sp folded before Flop (didn't bet)
Seat 3: aks932 folded before Flop (didn't bet)
Seat 4: elketefuka (button) showed [4c 5c] and lost with a pair of Queens
Seat 5: yamudda321 (small blind) folded before Flop
Seat 6: villmaðurin (big blind) folded before Flop
Seat 7: thief19.03.85 showed [Ah As] and won (57880) with two pair, Aces and Queens
Seat 8: TVRMikey folded on the Flop
Seat 9: rog3543 folded before Flop (didn't bet)
